people,state,party,total_senate_years,total_house_years,total_years
James Abdnor,South Dakota,Republican,6,8,14
Neil Abercrombie,Hawaii,Democratic,0,22,22
James Abourezk,South Dakota,Democratic,6,2,8
"Ralph Abraham, Lee",Louisiana,Republican,0,6,6
Spencer Abraham,Michigan,Republican,6,0,6
"Bella Abzug, S.",New York,Democratic,0,6,6
"Acevedo-Vila, Commissioner, Anibal",Puerto Rico,Democratic,0,4,4
"Gary Ackerman, L.",New York,Democratic,0,30,30
"Alma Adams, S.",North Carolina,Democratic,0,7,7
Brock Adams,Washington,Democratic,6,14,20
Sandy Adams,Florida,Republican,0,2,2
"Joseph Addabbo, P.",New York,Democratic,0,26,26
"Robert Aderholt, B.",Alabama,Republican,0,24,24
"John Adler, H.",New Jersey,Democratic,0,2,2
Pete Aguilar,California,Democratic,0,6,6
George Aiken,Vermont,Republican,34,0,34
"Daniel Akaka, K.",Hawaii,Democratic,23,14,37
"W. Akin, Todd",Missouri,Republican,0,12,12
Carl Albert,Oklahoma,Democratic,0,30,30
"Donald Albosta, J.",Michigan,Democratic,0,6,6
Bill Alexander,Arkansas,Democratic,0,24,24
Lamar Alexander,Tennessee,Republican,18,0,18
Rodney Alexander,Louisiana,Republican,0,10,10
Wayne Allard,Colorado,Republican,12,6,18
"Clifford Allen, R.",Tennessee,Democratic,0,4,4
George Allen,Virginia,Republican,6,2,8
"James Allen, B.",Alabama,Democratic,10,0,10
Maryon Allen,Alabama,Democratic,2,0,2
"Rick Allen, W.",Georgia,Republican,0,6,6
"Thomas Allen, H.",Maine,Democratic,0,12,12
"Colin Allred, Z.",Texas,Democratic,0,2,2
Jason Altmire,Pennsylvania,Democratic,0,6,6
Justin Amash,Michigan,Libertarian,0,10,10
"Jerome Ambro, A.",New York,Democratic,0,6,6
"Joseph Ammerman, S.",Pennsylvania,Democratic,0,2,2
"Mark Amodei, E.",Nevada,Republican,0,10,10
"Glenn Anderson, M.",California,Democratic,0,24,24
"John Anderson, B.",Illinois,Republican,0,20,20
"Wendell Anderson, R.",Minnesota,Democratic,2,0,2
Ike Andrews,North Carolina,Democratic,0,12,12
Mark Andrews,North Dakota,Republican,6,18,24
Michael Andrews,Texas,Democratic,0,12,12
"Robert Andrews, E.",New Jersey,Democratic,0,25,25
"Thomas Andrews, H.",Maine,Democratic,0,4,4
Frank Annunzio,Illinois,Democratic,0,28,28
"Beryl, Anthony, Jr.",Arkansas,Democratic,0,14,14
Douglas Applegate,Ohio,Democratic,0,18,18
Bill Archer,Texas,Republican,0,30,30
"Michael Arcuri, A.",New York,Democratic,0,4,4
"Leslie Arends, C.",Illinois,Republican,0,40,40
"Richard Armey, K.",Texas,Republican,0,18,18
Kelly Armstrong,North Dakota,Republican,0,2,2
"William Armstrong, L.",Colorado,Republican,12,6,18
"Jodey Arrington, C.",Texas,Republican,0,4,4
Jean Ashbrook,Ohio,Republican,0,2,2
"John Ashbrook, M.",Ohio,Republican,0,22,22
John Ashcroft,Missouri,Republican,6,0,6
Brad Ashford,Nebraska,Democratic,0,2,2
"Thomas Ashley, L.",Ohio,Democratic,0,26,26
Les Aspin,Wisconsin,Democratic,0,24,24
"Chester Atkins, G.",Massachusetts,Democratic,0,8,8
"Eugene Atkinson, V.",Pennsylvania,Democratic,0,4,4
Jake Auchincloss,Massachusetts,Democratic,0,0,0
Les AuCoin,Oregon,Democratic,0,18,18
Steve Austria,Ohio,Republican,0,4,4
Cynthia Axne,Iowa,Democratic,0,2,2
Kelly Ayotte,New Hampshire,Republican,6,0,6
Brian Babin,Texas,Republican,0,6,6
Joe Baca,California,Democratic,0,14,14
Jim Bacchus,Florida,Democratic,0,4,4
Michele Bachmann,Minnesota,Republican,0,8,8
Spencer Bachus,Alabama,Republican,0,22,22
Don Bacon,Nebraska,Republican,0,4,4
"Robert Badham, E.",California,Republican,0,12,12
Herman Badillo,New York,Democratic,0,8,8
Scotty Baesler,Kentucky,Democratic,0,6,6
L. Bafalis,Florida,Republican,0,10,10
"Donald Bailey, A.",Pennsylvania,Democratic,0,4,4
Wendell Bailey,Missouri,Republican,0,2,2
Brian Baird,Washington,Democratic,0,12,12
"James Baird, R.",Indiana,Republican,0,2,2
Bill Baker,California,Republican,0,4,4
Howard Baker,Tennessee,Republican,18,0,18
LaMar Baker,Tennessee,Republican,0,4,4
"Richard Baker, H.",Louisiana,Republican,0,21,21
"John Baldacci, Elias",Maine,Democratic,0,8,8
Troy Balderson,Ohio,Republican,0,3,3
"Alvin Baldus, J.",Wisconsin,Democratic,0,6,6
Tammy Baldwin,Wisconsin,Democratic,8,14,22
Frank Ballance,North Carolina,Democratic,0,1,1
Cass Ballenger,North Carolina,Republican,0,20,20
Jim Banks,Indiana,Republican,0,4,4
Ron Barber,Arizona,Democratic,0,3,3
Peter Barca,Wisconsin,Democratic,0,2,2
"James Barcia, A.",Michigan,Democratic,0,10,10
"Dean Barkley, M.",Minnesota,Independent,1,0,1
Lou Barletta,Pennsylvania,Republican,0,8,8
Tom Barlow,Kentucky,Democratic,0,2,2
"Doug, Barnard, Jr.",Georgia,Democratic,0,16,16
"Michael Barnes, D.",Maryland,Democratic,0,8,8
Andy Barr,Kentucky,Republican,0,8,8
Bob Barr,Georgia,Republican,0,8,8
"Nanette Barragan, Diaz",California,Democratic,0,4,4
John Barrasso,Wyoming,Republican,14,0,14
Bill Barrett,Nebraska,Republican,0,10,10
"J. Barrett, Gresham",South Carolina,Republican,0,8,8
"Thomas Barrett, M.",Wisconsin,Democratic,0,10,10
"William Barrett, A.",Pennsylvania,Democratic,0,30,30
John Barrow,Georgia,Democratic,0,10,10
"Dewey Bartlett, F.",Oklahoma,Republican,6,0,6
"Roscoe Bartlett, G.",Maryland,Republican,0,20,20
Steve Bartlett,Texas,Republican,0,10,10
Joe Barton,Texas,Republican,0,34,34
"Charles Bass, F.",New Hampshire,Republican,0,14,14
Karen Bass,California,Democratic,0,10,10
"Herbert Bateman, H.",Virginia,Republican,0,18,18
Jim Bates,California,Democratic,0,8,8
Max Baucus,Montana,Democratic,35,4,39
"Robert Bauman, E.",Maryland,Republican,0,8,8
Birch Bayh,Indiana,Democratic,18,0,18
Evan Bayh,Indiana,Democratic,12,0,12
J. Beall,Maryland,Republican,4,2,6
"Melissa Bean, L.",Illinois,Democratic,0,6,6
Edward Beard,Rhode Island,Democratic,0,6,6
Robin Beard,Tennessee,Republican,0,10,10
Joyce Beatty,Ohio,Democratic,0,8,8
Bob Beauprez,Colorado,Republican,0,4,4
Xavier Becerra,California,Democratic,0,24,24
"Berkley Bedell, W.",Iowa,Democratic,0,12,12
Mark Begich,Alaska,Democratic,6,0,6
"Anthony Beilenson, C.",California,Democratic,0,20,20
Alphonzo Bell,California,Republican,0,16,16
Chris Bell,Texas,Democratic,0,2,2
"Henry Bellmon, L.",Oklahoma,Republican,12,0,12
Cleve Benedict,West Virginia,Republican,0,2,2
Dan Benishek,Michigan,Republican,0,6,6
"Benitez, Commissioner, Jamie",Puerto Rico,Democratic,0,4,4
"Adam, Benjamin, Jr.",Indiana,Democratic,0,6,6
"Michael Bennet, F.",Colorado,Democratic,12,0,12
"Charles Bennett, E.",Florida,Democratic,0,44,44
"Robert Bennett, F.",Utah,Republican,18,0,18
"Wallace Bennett, F.",Utah,Republican,24,0,24
"Kerry Bentivolio, L.",Michigan,Republican,0,2,2
"Helen Bentley, Delich",Maryland,Republican,0,10,10
Ken Bentsen,Texas,Democratic,0,8,8
"Lloyd Bentsen, M.",Texas,Democratic,22,8,30
Cliff Bentz,Oregon,Republican,0,0,0
Ami Bera,California,Democratic,0,8,8
Doug Bereuter,Nebraska,Republican,0,25,25
Rick Berg,North Dakota,Republican,0,2,2
Bob Bergland,Minnesota,Republican,0,8,8
Jack Bergman,Michigan,Republican,0,4,4
Shelley Berkley,Nevada,Democratic,0,14,14
"Howard Berman, L.",California,Democratic,0,30,30
Marion Berry,Arkansas,Democratic,0,14,14
Ed Bethune,Arkansas,Republican,0,6,6
Tom Bevill,Alabama,Democratic,0,30,30
Donald Beyer,Virginia,Democratic,0,6,6
Mario Biaggi,New York,Democratic,0,20,20
Alan Bible,Nevada,Democratic,22,0,22
"Stephanie Bice, I.",Oklahoma,Republican,0,0,0
Joseph Biden,Delaware,Democratic,36,0,36
Edward Biester,Pennsylvania,Republican,0,10,10
Judy Biggert,Illinois,Republican,0,14,14
Andy Biggs,Arizona,Republican,0,4,4
"Brian Bilbray, P.",California,Republican,0,14,14
"James Bilbray, H.",Nevada,Democratic,0,8,8
"Gus Bilirakis, M.",Florida,Republican,0,14,14
Michael Bilirakis,Florida,Republican,0,24,24
Jeff Bingaman,New Mexico,Democratic,30,0,30
"Jonathan Bingham, B.",New York,Democratic,0,18,18
Dan Bishop,North Carolina,Republican,0,2,2
Mike Bishop,Michigan,Republican,0,4,4
Rob Bishop,Utah,Republican,0,18,18
Sanford Bishop,Georgia,Democratic,0,28,28
"Timothy Bishop, H.",New York,Democratic,0,12,12
Diane Black,Tennessee,Republican,0,8,8
Ben Blackburn,Georgia,Republican,0,8,8
Marsha Blackburn,Tennessee,Republican,2,16,18
"Lucien Blackwell, E.",Pennsylvania,Democratic,0,4,4
"Rod Blagojevich, R.",Illinois,Democratic,0,6,6
James Blanchard,Michigan,Democratic,0,8,8
"John Blatnik, Anton",Minnesota,Democratic,0,28,28
"Ben Blaz, G.",Guam,Republican,0,8,8
Tom Bliley,Virginia,Republican,0,20,20
Michael Blouin,Iowa,Democratic,0,4,4
Rod Blum,Iowa,Republican,0,4,4
Earl Blumenauer,Oregon,Democratic,0,26,26
Richard Blumenthal,Connecticut,Democratic,10,0,10
"Rochester, Blunt, Lisa",Delaware,Democratic,0,4,4
Roy Blunt,Missouri,Republican,10,14,24
"Peter Blute, I.",Massachusetts,Republican,0,4,4
"John Boccieri, A.",Ohio,Democratic,0,2,2
Lauren Boebert,Colorado,Republican,0,0,0
Sherwood Boehlert,New York,Republican,0,24,24
"John Boehner, A.",Ohio,Republican,0,24,24
Corinne Boggs,Louisiana,Democratic,0,18,18
"Edward Boland, P.",Massachusetts,Democratic,0,36,36
Richard Bolling,Missouri,Democratic,0,34,34
Suzanne Bonamici,Oregon,Democratic,0,9,9
"Christopher Bond, S.",Missouri,Republican,24,0,24
"William Boner, H.",Tennessee,Democratic,0,10,10
Henry Bonilla,Texas,Republican,0,14,14
"David Bonior, E.",Michigan,Democratic,0,26,26
Don Bonker,Washington,Democratic,0,14,14
Jo Bonner,Alabama,Republican,0,10,10
"Mack, Bono, Mary",California,Republican,0,16,16
Sonny Bono,California,Republican,0,4,4
"Cory Booker, A.",New Jersey,Democratic,8,0,8
John Boozman,Arkansas,Republican,10,10,20
"Madeleine Bordallo, Z.",Guam,Democratic,0,16,16
Dan Boren,Oklahoma,Democratic,0,8,8
"David Boren, L.",Oklahoma,Democratic,16,0,16
"Robert Borski, A.",Pennsylvania,Democratic,0,20,20
Rudy Boschwitz,Minnesota,Republican,12,0,12
"Douglas Bosco, H.",California,Democratic,0,8,8
Mike Bost,Illinois,Republican,0,6,6
"Leonard Boswell, L.",Iowa,Democratic,0,16,16
Rick Boucher,Virginia,Democratic,0,28,28
Beau Boulter,Texas,Republican,0,4,4
Carolyn Bourdeaux,Georgia,Democratic,0,0,0
Charles Boustany,Louisiana,Republican,0,12,12
"David Bowen, R.",Mississippi,Democratic,0,10,10
Jamaal Bowman,New York,Democratic,0,0,0
Barbara Boxer,California,Democratic,24,10,34
Allen Boyd,Florida,Democratic,0,14,14
"Nancy Boyda, E.",Kansas,Democratic,0,2,2
"Brendan Boyle, F.",Pennsylvania,Democratic,0,6,6
John Brademas,Indiana,Democratic,0,22,22
Bill Bradley,New Jersey,Democratic,18,0,18
Jeb Bradley,New Hampshire,Republican,0,4,4
Kevin Brady,Texas,Republican,0,24,24
Nicholas Brady,New Jersey,Republican,2,0,2
"Robert Brady, A.",Pennsylvania,Democratic,0,22,22
"Bruce Braley, L.",Iowa,Democratic,0,8,8
Frank Brasco,New York,Democratic,0,8,8
Dave Brat,Virginia,Republican,0,5,5
Mike Braun,Indiana,Republican,2,0,2
"William Bray, G.",Indiana,Republican,0,24,24
"John Breaux, B.",Louisiana,Democratic,18,16,34
"John Breckinridge, B.",Kentucky,Democratic,0,6,6
"Joseph Brennan, E.",Maine,Democratic,0,4,4
"Bill Brewster, K.",Oklahoma,Democratic,0,6,6
Jim Bridenstine,Oklahoma,Republican,0,5,5
Bobby Bright,Alabama,Democratic,0,2,2
Anthony Brindisi,New York,Democratic,0,2,2
Jack Brinkley,Georgia,Democratic,0,16,16
Robin Britt,North Carolina,Democratic,0,2,2
Bill Brock,Tennessee,Republican,6,8,14
William Brodhead,Michigan,Democratic,0,8,8
"Edward Brooke, W.",Massachusetts,Republican,12,0,12
"Jack Brooks, B.",Texas,Democratic,0,42,42
Mo Brooks,Alabama,Republican,0,10,10
"Susan Brooks, W.",Indiana,Republican,0,8,8
"William Broomfield, S.",Michigan,Republican,0,36,36
"Donald Brotzman, G.",Colorado,Republican,0,10,10
"Paul Broun, C.",Georgia,Republican,0,8,8
Glen Browder,Alabama,Democratic,0,8,8
"Anthony Brown, G.",Maryland,Democratic,0,4,4
"Clarence, Brown, Jr.",Ohio,Republican,0,18,18
Corrine Brown,Florida,Democratic,0,24,24
"Garry Brown, E.",Michigan,Republican,0,12,12
George Brown,California,Democratic,0,36,36
Hank Brown,Colorado,Republican,6,10,16
Henry Brown,South Carolina,Republican,0,10,10
"Scott Brown, P.",Massachusetts,Republican,3,0,3
Sherrod Brown,Ohio,Democratic,14,14,28
Ginny Brown-Waite,Florida,Republican,0,8,8
Sam Brownback,Kansas,Republican,15,1,16
Julia Brownley,California,Democratic,0,8,8
"James Broyhill, T.",North Carolina,Republican,1,23,24
"Joel Broyhill, T.",Virginia,Republican,0,22,22
"Terry Bruce, L.",Illinois,Democratic,0,8,8
"Richard Bryan, H.",Nevada,Democratic,12,0,12
Ed Bryant,Tennessee,Republican,0,8,8
"John Bryant, W.",Texas,Democratic,0,14,14
John Buchanan,Alabama,Republican,0,16,16
Vern Buchanan,Florida,Republican,0,14,14
Ken Buck,Colorado,Republican,0,6,6
"James Buckley, L.",New York,Republican,6,0,6
Larry Bucshon,Indiana,Republican,0,10,10
Ted Budd,North Carolina,Republican,0,4,4
Jack Buechner,Missouri,Republican,0,4,4
"Ann Buerkle, Marie",New York,Republican,0,2,2
Dale Bumpers,Arkansas,Democratic,24,0,24
Jim Bunn,Oregon,Republican,0,2,2
Jim Bunning,Kentucky,Republican,12,12,24
Tim Burchett,Tennessee,Republican,0,2,2
Jocelyn Burdick,North Dakota,Democratic,2,0,2
"Quentin Burdick, N.",North Dakota,Democratic,34,0,34
"Clair Burgener, W.",California,Republican,0,10,10
"Michael Burgess, C.",Texas,Republican,0,18,18
"J. Burke, Herbert",Florida,Republican,0,12,12
"James Burke, A.",Massachusetts,Democratic,0,20,20
"Yvonne Burke, B.",California,Democratic,0,6,6
Omar Burleson,Texas,Democratic,0,32,32
"Bill Burlison, D.",Missouri,Democratic,0,12,12
"Conrad Burns, R.",Montana,Republican,18,0,18
Max Burns,Georgia,Republican,0,2,2
Richard Burr,North Carolina,Republican,16,10,26
Roland Burris,Illinois,Democratic,1,0,1
Dan Burton,Indiana,Republican,0,30,30
John Burton,California,Democratic,0,10,10
Phillip Burton,California,Democratic,0,22,22
Sala Burton,California,Democratic,0,6,6
Cori Bush,Missouri,Democratic,0,0,0
"Albert Bustamante, G.",Texas,Democratic,0,8,8
Cheri Bustos,Illinois,Democratic,0,8,8
"M. Butler, Caldwell",Virginia,Republican,0,12,12
"G. Butterfield, K.",North Carolina,Democratic,0,17,17
Steve Buyer,Indiana,Republican,0,18,18
Harry Byrd,Virginia,Independent,18,0,18
"Robert Byrd, C.",West Virginia,Democratic,51,6,57
Bradley Byrne,Alabama,Republican,0,7,7
"Leslie Byrne, L.",Virginia,Democratic,0,2,2
"Beverly Byron, B.",Maryland,Democratic,0,14,14
"Goodloe Byron, E.",Maryland,Democratic,0,8,8
Sonny Callahan,Alabama,Republican,0,18,18
Ken Calvert,California,Republican,0,28,28
Kat Cammack,Florida,Republican,0,0,0
Dave Camp,Michigan,Republican,0,24,24
John Camp,Oklahoma,Republican,0,6,6
"Ben Campbell, Nighthorse",Colorado,Republican,12,6,18
Carroll Campbell,South Carolina,Republican,0,8,8
John Campbell,California,Republican,0,10,10
Tom Campbell,California,Republican,0,10,10
"Charles Canady, T.",Florida,Republican,0,8,8
Chris Cannon,Utah,Republican,0,12,12
"Howard Cannon, W.",Nevada,Democratic,24,0,24
"Francisco Canseco, ""Quico""",Texas,Republican,0,2,2
Eric Cantor,Virginia,Republican,0,13,13
Maria Cantwell,Washington,Democratic,20,2,22
"Anh Cao, ""Joseph""",Louisiana,Republican,0,2,2
"Shelley Capito, Moore",West Virginia,Republican,6,14,20
Lois Capps,California,Democratic,0,20,20
Walter Capps,California,Democratic,0,2,2
"Michael Capuano, E.",Massachusetts,Democratic,0,20,20
"Bruce Caputo, F.",New York,Republican,0,2,2
"Salud Carbajal, O.",California,Democratic,0,4,4
Tony Cardenas,California,Democratic,0,8,8
"Benjamin Cardin, L.",Maryland,Democratic,14,20,34
"Dennis Cardoza, A.",California,Democratic,0,9,9
"Hugh Carey, L.",New York,Democratic,0,14,14
"Jerry Carl, L.",Alabama,Republican,0,0,0
"Gregory Carman, W.",New York,Republican,0,2,2
Jean Carnahan,Missouri,Democratic,1,0,1
Russ Carnahan,Missouri,Democratic,0,8,8
"Charles Carney, J.",Ohio,Democratic,0,10,10
"Christopher Carney, P.",Pennsylvania,Democratic,0,4,4
John Carney,Delaware,Democratic,0,6,6
William Carney,New York,Republican,0,8,8
"Thomas Carper, R.",Delaware,Democratic,20,10,30
Bob Carr,Michigan,Democratic,0,18,18
Andre Carson,Indiana,Democratic,0,13,13
Brad Carson,Oklahoma,Democratic,0,4,4
Julia Carson,Indiana,Democratic,0,10,10
Earl Carter,Georgia,Republican,0,6,6
"John Carter, R.",Texas,Republican,0,18,18
"Tim Carter, Lee",Kentucky,Republican,0,16,16
Troy Carter,Louisiana,Democratic,0,0,0
Matt Cartwright,Pennsylvania,Democratic,0,8,8
"Clifford Case, P.",New Jersey,Republican,24,10,34
Ed Case,Hawaii,Democratic,0,7,7
Bob Casey,Texas,Democratic,0,18,18
Robert Casey,Pennsylvania,Democratic,14,0,14
Bill Cassidy,Louisiana,Republican,6,6,12
Sean Casten,Illinois,Democratic,0,2,2
"Michael Castle, N.",Delaware,Republican,0,18,18
Kathy Castor,Florida,Democratic,0,14,14
Joaquin Castro,Texas,Democratic,0,8,8
"John Cavanaugh, J.",Nebraska,Democratic,0,4,4
Madison Cawthorn,North Carolina,Republican,0,0,0
Donald Cazayoux,Louisiana,Democratic,0,1,1
"Elford Cederberg, A.",Michigan,Republican,0,26,26
Steve Chabot,Ohio,Republican,0,24,24
"John Chafee, H.",Rhode Island,Republican,22,0,22
Lincoln Chafee,Rhode Island,Republican,8,0,8
Jason Chaffetz,Utah,Republican,0,8,8
"Charles Chamberlain, E.",Michigan,Republican,0,18,18
Saxby Chambliss,Georgia,Republican,12,8,20
Ben Chandler,Kentucky,Democratic,0,9,9
"Rod Chandler, D.",Washington,Republican,0,10,10
Jim Chapman,Texas,Democratic,0,12,12
"Bill, Chappell, Jr.",Florida,Democratic,0,20,20
"Eugene Chappie, A.",California,Republican,0,6,6
Dick Cheney,Wyoming,Republican,0,12,12
Liz Cheney,Wyoming,Republican,0,4,4
Helen Chenoweth-Hage,Idaho,Republican,0,6,6
Jeff Chiesa,New Jersey,Republican,0,0,0
Travis Childers,Mississippi,Democratic,0,3,3
Lawton Chiles,Florida,Democratic,18,0,18
Shirley Chisholm,New York,Democratic,0,14,14
Chris Chocola,Indiana,Republican,0,4,4
"Donna Christensen, M.",Virgin Islands,Democratic,0,18,18
Jon Christensen,Nebraska,Republican,0,4,4
Dick Chrysler,Michigan,Republican,0,2,2
Judy Chu,California,Democratic,0,12,12
Frank Church,Idaho,Democratic,24,0,24
"David Cicilline, N.",Rhode Island,Democratic,0,10,10
Gilbert Cisneros,California,Democratic,0,2,2
"Donald Clancy, D.",Ohio,Republican,0,16,16
Dick Clark,Iowa,Democratic,6,0,6
"Frank Clark, M.",Pennsylvania,Democratic,0,20,20
"Katherine Clark, M.",Massachusetts,Democratic,0,8,8
Hansen Clarke,Michigan,Democratic,0,2,2
"James Clarke, McC.",North Carolina,Democratic,0,6,6
"Yvette Clarke, D.",New York,Democratic,0,14,14
"Don Clausen, H.",California,Republican,0,20,20
Curt Clawson,Florida,Republican,0,3,3
Del Clawson,California,Republican,0,16,16
"William Clay, (Bill)",Missouri,Democratic,0,32,32
"Wm. Clay, Lacy",Missouri,Democratic,0,20,20
"Eva Clayton, M.",North Carolina,Democratic,0,12,12
Emanuel Cleaver,Missouri,Democratic,0,16,16
Max Cleland,Georgia,Democratic,6,0,6
Bob Clement,Tennessee,Democratic,0,16,16
"James Cleveland, C.",New Hampshire,Republican,0,18,18
Ben Cline,Virginia,Republican,0,2,2
William Clinger,Pennsylvania,Republican,0,18,18
"Hillary Clinton, Rodham",New York,Democratic,8,0,8
Michael Cloud,Texas,Republican,0,3,3
"James Clyburn, E.",South Carolina,Democratic,0,28,28
"Andrew Clyde, S.",Georgia,Republican,0,0,0
Daniel Coats,Indiana,Republican,16,8,24
"William Cobey, W.",North Carolina,Republican,0,2,2
Howard Coble,North Carolina,Republican,0,30,30
Tom Coburn,Oklahoma,Republican,10,6,16
Thad Cochran,Mississippi,Republican,39,6,45
"Anthony Coelho, Lee",California,Democratic,0,12,12
Mike Coffman,Colorado,Republican,0,10,10
Steve Cohen,Tennessee,Democratic,0,14,14
"William Cohen, S.",Maine,Republican,18,6,24
Tom Cole,Oklahoma,Republican,0,18,18
"E. Coleman, Thomas",Missouri,Republican,0,16,16
Norm Coleman,Minnesota,Republican,6,0,6
"Ronald Coleman, D.",Texas,Democratic,0,14,14
"Harold Collier, R.",Illinois,Republican,0,18,18
Barbara-Rose Collins,Michigan,Democratic,0,6,6
Cardiss Collins,Illinois,Democratic,0,24,24
Chris Collins,New York,Republican,0,6,6
Doug Collins,Georgia,Republican,0,8,8
"James Collins, M.",Texas,Republican,0,16,16
Mac Collins,Georgia,Republican,0,12,12
"Susan Collins, M.",Maine,Republican,24,0,24
"Colorado, Commissioner, Antonio",Puerto Rico,Democratic,0,2,2
Larry Combest,Texas,Republican,0,18,18
James Comer,Kentucky,Republican,0,5,5
Barbara Comstock,Virginia,Republican,0,4,4
Barber Conable,New York,Republican,0,20,20
"K. Conaway, Michael",Texas,Republican,0,16,16
"Gary Condit, A.",California,Democratic,0,14,14
"John Conlan, B.",Arizona,Republican,0,4,4
"Gerald Connolly, E.",Virginia,Democratic,0,12,12
Kent Conrad,North Dakota,Democratic,26,0,26
"Silvio Conte, O.",Massachusetts,Republican,0,34,34
"John, Conyers, Jr.",Michigan,Democratic,0,52,52
"Marlow Cook, W.",Kentucky,Republican,8,0,8
Merrill Cook,Utah,Republican,0,4,4
Paul Cook,California,Republican,0,7,7
John Cooksey,Louisiana,Republican,0,6,6
Wes Cooley,Oregon,Republican,0,2,2
"Christopher Coons, A.",Delaware,Democratic,11,0,11
Jim Cooper,Tennessee,Democratic,0,30,30
Sam Coppersmith,Arizona,Democratic,0,2,2
Tom Corcoran,Illinois,Republican,0,8,8
Bob Corker,Tennessee,Republican,12,0,12
"James Corman, C.",California,Democratic,0,20,20
"Robert Cornell, J.",Wisconsin,Democratic,0,4,4
"David Cornwell, L.",Indiana,Democratic,0,2,2
John Cornyn,Texas,Republican,19,0,19
"Corrada, Commissioner, Baltasar",Puerto Rico,Independent,0,10,10
"J. Correa, Luis",California,Democratic,0,4,4
"Masto, Cortez, Catherine",Nevada,Democratic,4,0,4
"Jon Corzine, S.",New Jersey,Democratic,5,0,5
Jim Costa,California,Democratic,0,16,16
"Jerry Costello, F.",Illinois,Democratic,0,26,26
"Ryan Costello, A.",Pennsylvania,Republican,0,4,4
"William Cotter, R.",Connecticut,Democratic,0,12,12
Norris Cotton,New Hampshire,Republican,24,6,30
Tom Cotton,Arkansas,Republican,6,2,8
Lawrence Coughlin,Pennsylvania,Republican,0,24,24
Jim Courter,New Jersey,Republican,0,12,12
Joe Courtney,Connecticut,Democratic,0,14,14
Paul Coverdell,Georgia,Republican,7,0,7
"William Cowan, M.",Massachusetts,Democratic,0,0,0
Christopher Cox,California,Republican,0,18,18
John Cox,Illinois,Democratic,0,2,2
TJ Cox,California,Democratic,0,2,2
"James Coyne, K.",Pennsylvania,Republican,0,2,2
"William Coyne, J.",Pennsylvania,Democratic,0,22,22
Angie Craig,Minnesota,Democratic,0,2,2
"Larry Craig, E.",Idaho,Republican,18,10,28
Kevin Cramer,North Dakota,Republican,2,6,8
Robert Cramer,Alabama,Democratic,0,18,18
"Daniel Crane, B.",Illinois,Republican,0,6,6
"Philip Crane, M.",Illinois,Republican,0,36,36
Alan Cranston,California,Democratic,24,0,24
Mike Crapo,Idaho,Republican,22,6,28
Chip Cravaack,Minnesota,Republican,0,2,2
Eric Crawford,Arkansas,Republican,0,10,10
"Frank Cremeans, A.",Ohio,Republican,0,2,2
Ander Crenshaw,Florida,Republican,0,16,16
Dan Crenshaw,Texas,Republican,0,2,2
Charlie Crist,Florida,Democratic,0,4,4
"Mark Critz, S.",Pennsylvania,Democratic,0,3,3
George Crockett,Michigan,Democratic,0,12,12
"Paul Cronin, W.",Massachusetts,Republican,0,2,2
Jason Crow,Colorado,Democratic,0,2,2
Joseph Crowley,New York,Democratic,0,20,20
Ted Cruz,Texas,Republican,8,0,8
Barbara Cubin,Wyoming,Republican,0,14,14
Henry Cuellar,Texas,Democratic,0,16,16
"John Culberson, Abney",Texas,Republican,0,18,18
"John Culver, C.",Iowa,Democratic,6,10,16
"Elijah Cummings, E.",Maryland,Democratic,0,24,24
Joe Cunningham,South Carolina,Democratic,0,2,2
John Cunningham,Washington,Republican,0,2,2
"Randy Cunningham, (Duke)",California,Republican,0,16,16
Carlos Curbelo,Florida,Republican,0,4,4
"David Curson, Alan",Michigan,Democratic,0,1,1
"Carl Curtis, T.",Nebraska,Republican,24,16,40
"John Curtis, R.",Utah,Republican,0,4,4
Alfonse D'Amato,New York,Republican,18,0,18
"Norman D'Amours, E.",New Hampshire,Democratic,0,10,10
"Kathleen Dahlkemper, A.",Pennsylvania,Democratic,0,2,2
Steve Daines,Montana,Republican,6,2,8
"John Danforth, C.",Missouri,Republican,18,0,18
Robert Daniel,Virginia,Republican,0,10,10
W. Daniel,Virginia,Democratic,0,20,20
"Dominick Daniels, V.",New Jersey,Democratic,0,18,18
"George Danielson, E.",California,Democratic,0,12,12
"William Dannemeyer, E.",California,Republican,0,14,14
Pat Danner,Missouri,Democratic,0,8,8
"George Darden, (Buddy)",Georgia,Democratic,0,12,12
"Thomas Daschle, A.",South Dakota,Democratic,18,8,26
Hal Daub,Nebraska,Republican,0,8,8
Sharice Davids,Kansas,Democratic,0,2,2
Warren Davidson,Ohio,Republican,0,5,5
Artur Davis,Alabama,Democratic,0,8,8
"Danny Davis, K.",Illinois,Democratic,0,24,24
David Davis,Tennessee,Republican,0,2,2
Geoff Davis,Kentucky,Republican,0,7,7
"Glenn Davis, R.",Wisconsin,Republican,0,20,20
Jack Davis,Illinois,Republican,0,2,2
Jim Davis,Florida,Democratic,0,10,10
"Jo Davis, Ann",Virginia,Republican,0,6,6
"John Davis, W.",Georgia,Democratic,0,14,14
Lincoln Davis,Tennessee,Democratic,0,8,8
"Mendel Davis, J.",South Carolina,Democratic,0,10,10
"Robert Davis, W.",Michigan,Republican,0,14,14
Rodney Davis,Illinois,Republican,0,8,8
"Susan Davis, A.",California,Democratic,0,20,20
Tom Davis,Virginia,Republican,0,13,13
Mark Dayton,Minnesota,Democratic,6,0,6
la de,Texas,Democratic,0,32,32
"Lugo, de, Ron",Virgin Islands,Democratic,0,20,20
Nathan Deal,Georgia,Republican,0,17,17
Madeleine Dean,Pennsylvania,Democratic,0,2,2
Joel Deckard,Indiana,Republican,0,4,4
Dennis DeConcini,Arizona,Democratic,18,0,18
"Peter DeFazio, A.",Oregon,Democratic,0,34,34
Diana DeGette,Colorado,Democratic,0,24,24
Bill Delahunt,Massachusetts,Democratic,0,14,14
"James Delaney, J.",New York,Democratic,0,34,34
"John Delaney, K.",Maryland,Democratic,0,6,6
"Rosa DeLauro, L.",Connecticut,Democratic,0,30,30
Tom DeLay,Texas,Republican,0,22,22
"Suzan DelBene, K.",Washington,Democratic,0,9,9
Antonio Delgado,New York,Democratic,0,2,2
John Dellenback,Oregon,Republican,0,8,8
"Ronald Dellums, V.",California,Democratic,0,28,28
"Val Demings, Butler",Florida,Democratic,0,4,4
Jim DeMint,South Carolina,Republican,7,6,13
"Lawrence DeNardis, J.",Connecticut,Republican,0,2,2
Jeff Denham,California,Republican,0,8,8
"Frank Denholm, E.",South Dakota,Democratic,0,4,4
"David Dennis, W.",Indiana,Republican,0,6,6
"Charles Dent, W.",Pennsylvania,Republican,0,13,13
"John Dent, H.",Pennsylvania,Democratic,0,22,22
Jeremiah Denton,Alabama,Republican,6,0,6
"Butler Derrick, C.",South Carolina,Democratic,0,20,20
"Edward Derwinski, J.",Illinois,Republican,0,24,24
Ron DeSantis,Florida,Republican,0,5,5
Mark DeSaulnier,California,Democratic,0,6,6
Scott DesJarlais,Tennessee,Republican,0,10,10
"Theodore Deutch, E.",Florida,Democratic,0,11,11
Peter Deutsch,Florida,Democratic,0,12,12
"Samuel Devine, L.",Ohio,Republican,0,22,22
Mike DeWine,Ohio,Republican,12,8,20
Lincoln Diaz-Balart,Florida,Republican,0,18,18
Mario Diaz-Balart,Florida,Republican,0,18,18
Jay Dickey,Arkansas,Republican,0,8,8
"William Dickinson, L.",Alabama,Republican,0,28,28
"Norman Dicks, D.",Washington,Democratic,0,36,36
Charles Diggs,Michigan,Democratic,0,26,26
Debbie Dingell,Michigan,Democratic,0,6,6
"John Dingell, D.",Michigan,Democratic,0,60,60
"Joseph DioGuardi, J.",New York,Republican,0,4,4
"Alan Dixon, J.",Illinois,Democratic,12,0,12
"Julian Dixon, C.",California,Democratic,0,24,24
"Charles Djou, K.",Hawaii,Republican,0,1,1
"Christopher Dodd, J.",Connecticut,Democratic,30,6,36
Lloyd Doggett,Texas,Democratic,0,26,26
"Robert Dold, J.",Illinois,Republican,0,4,4
Elizabeth Dole,North Carolina,Republican,6,0,6
"Robert Dole, J.",Kansas,Republican,28,8,36
"Pete Domenici, V.",New Mexico,Republican,36,0,36
"Peter Dominick, H.",Colorado,Republican,2,2,4
Byron Donalds,Florida,Republican,0,0,0
"Brian Donnelly, J.",Massachusetts,Democratic,0,14,14
Joe Donnelly,Indiana,Democratic,6,6,12
"Harold Donohue, D.",Massachusetts,Democratic,0,28,28
Daniel Donovan,New York,Republican,0,4,4
"Calvin Dooley, M.",California,Democratic,0,14,14
"John Doolittle, T.",California,Republican,0,18,18
"Byron Dorgan, L.",North Dakota,Democratic,20,12,32
William Dorn,South Carolina,Democratic,0,26,26
"Robert Dornan, K.",California,Republican,0,18,18
"Charles Dougherty, F.",Pennsylvania,Republican,0,4,4
Chuck Douglas,New Hampshire,Republican,0,2,2
Wayne Dowdy,Mississippi,Democratic,0,8,8
"Thomas Downey, J.",New York,Democratic,0,18,18
"Thomas Downing, N.",Virginia,Democratic,0,18,18
"Michael Doyle, F.",Pennsylvania,Democratic,0,26,26
"Thelma Drake, D.",Virginia,Republican,0,4,4
David Dreier,California,Republican,0,32,32
Steve Driehaus,Ohio,Democratic,0,2,2
"Robert Drinan, F.",Massachusetts,Democratic,0,10,10
"Pont, du",Delaware,Republican,0,6,6
Tammy Duckworth,Illinois,Democratic,4,4,8
"Sean Duffy, P.",Wisconsin,Republican,0,8,8
"Thaddeus Dulski, J.",New York,Democratic,0,16,16
Jeff Duncan,South Carolina,Republican,0,10,10
"John Duncan, J.",Tennessee,Republican,0,24,24
John Duncan,Tennessee,Republican,0,32,32
"Robert Duncan, B.",Oregon,Democratic,0,10,10
Jennifer Dunn,Washington,Republican,0,12,12
Jim Dunn,Michigan,Republican,0,2,2
"Neal Dunn, P.",Florida,Republican,0,4,4
"Richard Durbin, J.",Illinois,Democratic,24,14,38
Dave Durenberger,Minnesota,Republican,18,0,18
"John Durkin, A.",New Hampshire,Democratic,6,0,6
"Bernard Dwyer, J.",New Jersey,Democratic,0,12,12
"Mervyn Dymally, M.",California,Democratic,0,12,12
Roy Dyson,Maryland,Democratic,0,10,10
"Thomas Eagleton, F.",Missouri,Democratic,20,0,20
"Joseph Early, D.",Massachusetts,Democratic,0,18,18
"John East, P.",North Carolina,Republican,6,0,6
"James Eastland, O.",Mississippi,Democratic,38,0,38
"Dennis Eckart, E.",Ohio,Democratic,0,12,12
"Fred Eckert, J.",New York,Republican,0,2,2
Bob Eckhardt,Texas,Democratic,0,14,14
"Robert Edgar, W.",Pennsylvania,Democratic,0,12,12
Chet Edwards,Texas,Democratic,0,20,20
Don Edwards,California,Democratic,0,32,32
"Donna Edwards, F.",Maryland,Democratic,0,9,9
Jack Edwards,Alabama,Republican,0,20,20
John Edwards,North Carolina,Democratic,6,0,6
Mickey Edwards,Oklahoma,Republican,0,16,16
"Vernon Ehlers, J.",Michigan,Republican,0,18,18
Robert Ehrlich,Maryland,Republican,0,8,8
Joshua Eilberg,Pennsylvania,Democratic,0,12,12
Keith Ellison,Minnesota,Democratic,0,12,12
"Renee Ellmers, L.",North Carolina,Republican,0,6,6
Brad Ellsworth,Indiana,Democratic,0,4,4
Rahm Emanuel,Illinois,Democratic,0,6,6
Bill Emerson,Missouri,Republican,0,16,16
"Jo Emerson, Ann",Missouri,Republican,0,16,16
"David Emery, F.",Maine,Republican,0,8,8
Tom Emmer,Minnesota,Republican,0,6,6
"Eliot Engel, L.",New York,Democratic,0,32,32
Glenn English,Oklahoma,Democratic,0,20,20
Karan English,Arizona,Democratic,0,2,2
Phil English,Pennsylvania,Republican,0,14,14
John Ensign,Nevada,Republican,10,4,14
"William Enyart, L.",Illinois,Democratic,0,2,2
"Michael Enzi, B.",Wyoming,Republican,24,0,24
Arlen Erdahl,Minnesota,Republican,0,4,4
Ben Erdreich,Alabama,Democratic,0,10,10
"John Erlenborn, N.",Illinois,Republican,0,20,20
Joni Ernst,Iowa,Republican,6,0,6
"Allen Ertel, E.",Pennsylvania,Democratic,0,6,6
Sam Ervin,North Carolina,Democratic,2,2,4
"Marvin Esch, L.",Michigan,Republican,0,10,10
Veronica Escobar,Texas,Democratic,0,2,2
"Edwin Eshleman, D.",Pennsylvania,Republican,0,10,10
"Anna Eshoo, G.",California,Democratic,0,28,28
Adriano Espaillat,New York,Democratic,0,4,4
Mike Espy,Mississippi,Democratic,0,8,8
Ron Estes,Kansas,Republican,0,4,4
"Elizabeth Esty, H.",Connecticut,Democratic,0,6,6
Bob Etheridge,North Carolina,Democratic,0,14,14
"Billy Evans, Lee",Georgia,Democratic,0,6,6
Cooper Evans,Iowa,Republican,0,6,6
"Daniel Evans, J.",Washington,Republican,6,0,6
"David Evans, W.",Indiana,Democratic,0,8,8
Dwight Evans,Pennsylvania,Democratic,0,5,5
"Frank Evans, E.",Colorado,Democratic,0,14,14
Lane Evans,Illinois,Democratic,0,24,24
"Melvin Evans, H.",Virgin Islands,Republican,0,2,2
Thomas Evans,Delaware,Republican,0,6,6
Terry Everett,Alabama,Republican,0,16,16
"Joe Evins, L.",Tennessee,Democratic,0,30,30
"Thomas Ewing, W.",Illinois,Republican,0,10,10
"J. Exon, James",Nebraska,Democratic,18,0,18
Lauch Faircloth,North Carolina,Republican,6,0,6
Eni Faleomavaega,American Samoa,Democratic,0,26,26
Mary Fallin,Oklahoma,Republican,0,4,4
Pat Fallon,Texas,Republican,0,0,0
"Paul Fannin, J.",Arizona,Republican,12,0,12
Blake Farenthold,Texas,Republican,0,7,7
Sam Farr,California,Democratic,0,24,24
"John Fary, G.",Illinois,Democratic,0,8,8
"Dante Fascell, B.",Florida,Democratic,0,38,38
"John Faso, J.",New York,Republican,0,2,2
Chaka Fattah,Pennsylvania,Democratic,0,21,21
"Walter Fauntroy, E.",District of Columbia,Democratic,0,20,20
"Harris Fawell, W.",Illinois,Republican,0,14,14
Vic Fazio,California,Democratic,0,20,20
Tom Feeney,Florida,Republican,0,6,6
Randy Feenstra,Iowa,Republican,0,0,0
"Edward Feighan, F.",Ohio,Democratic,0,10,10
"Russell Feingold, D.",Wisconsin,Democratic,18,0,18
Dianne Feinstein,California,Democratic,29,0,29
"Millicent Fenwick, H.",New Jersey,Republican,0,8,8
A. Ferguson,Georgia,Republican,0,4,4
Mike Ferguson,New Jersey,Republican,0,8,8
"Geraldine Ferraro, A.",New York,Democratic,0,6,6
Bobbi Fiedler,California,Republican,0,6,6
Cleo Fields,Louisiana,Democratic,0,4,4
Jack Fields,Texas,Republican,0,16,16
Bob Filner,California,Democratic,0,20,20
"Stephen Fincher, Lee",Tennessee,Republican,0,6,6
Paul Findley,Illinois,Republican,0,22,22
"Eric Fingerhut, D.",Ohio,Democratic,0,2,2
Abby Finkenauer,Iowa,Democratic,0,2,2
Michelle Fischbach,Minnesota,Republican,0,0,0
Deb Fischer,Nebraska,Republican,8,0,8
"Hamilton, Fish, Jr.",New York,Republican,0,26,26
"Joesph Fisher, L.",Virginia,Democratic,0,6,6
"O. Fisher, C.",Texas,Democratic,0,32,32
"Floyd Fithian, J.",Indiana,Democratic,0,8,8
Peter Fitzgerald,Illinois,Republican,6,0,6
Scott Fitzgerald,Wisconsin,Republican,0,0,0
"Brian Fitzpatrick, K.",Pennsylvania,Republican,0,4,4
"Michael Fitzpatrick, G.",Pennsylvania,Republican,0,8,8
"Floyd Flake, H.",New York,Democratic,0,12,12
Jeff Flake,Arizona,Republican,6,12,18
"Michael Flanagan, Patrick",Illinois,Republican,0,2,2
Charles Fleischmann,Tennessee,Republican,0,10,10
John Fleming,Louisiana,Republican,0,8,8
Ernie Fletcher,Kentucky,Republican,0,4,4
Lizzie Fletcher,Texas,Democratic,0,2,2
"Ronnie Flippo, G.",Alabama,Democratic,0,14,14
"Daniel Flood, J.",Pennsylvania,Democratic,0,28,28
Bill Flores,Texas,Republican,0,10,10
"James Florio, J.",New Jersey,Democratic,0,16,16
Walter Flowers,Alabama,Democratic,0,10,10
John Flynt,Georgia,Democratic,0,26,26
"Thomas Foglietta, M.",Pennsylvania,Democratic,0,18,18
Mark Foley,Florida,Republican,0,12,12
"Thomas Foley, S.",Washington,Democratic,0,30,30
"Hiram Fong, L.",Hawaii,Republican,18,0,18
"J. Forbes, Randy",Virginia,Republican,0,16,16
"Michael Forbes, P.",New York,Democratic,0,6,6
Gerald Ford,Michigan,Republican,0,26,26
"Harold Ford, E.",Tennessee,Democratic,0,22,22
Harold Ford,Tennessee,Democratic,0,10,10
"Wendell Ford, H.",Kentucky,Democratic,24,0,24
"William Ford, D.",Michigan,Democratic,0,30,30
"Edwin Forsythe, B.",New Jersey,Republican,0,16,16
Jeff Fortenberry,Nebraska,Republican,0,16,16
"Fortuno, Commissioner",Puerto Rico,Republican,0,4,4
Vito Fossella,New York,Republican,0,12,12
Bill Foster,Illinois,Democratic,0,11,11
"L. Fountain, H.",North Carolina,Democratic,0,30,30
Tillie Fowler,Florida,Republican,0,8,8
"Wyche, Fowler, Jr.",Georgia,Democratic,6,10,16
"Jon Fox, D.",Pennsylvania,Republican,0,4,4
Virginia Foxx,North Carolina,Republican,0,16,16
Sheila Frahm,Kansas,Republican,2,0,2
Barney Frank,Massachusetts,Democratic,0,32,32
Lois Frankel,Florida,Democratic,0,8,8
Al Franken,Minnesota,Democratic,9,0,9
"C. Franklin, Scott",Florida,Republican,0,0,0
"William Franklin, W.",Mississippi,Republican,0,4,4
Bob Franks,New Jersey,Republican,0,8,8
"Gary Franks, A.",Connecticut,Republican,0,6,6
Trent Franks,Arizona,Republican,0,14,14
"Donald Fraser, M.",Minnesota,Democratic,0,16,16
"Victor Frazer, O.",Virgin Islands,Independent,0,2,2
Peter Frelinghuysen,New Jersey,Republican,0,22,22
"Rodney Frelinghuysen, P.",New Jersey,Republican,0,24,24
Bill Frenzel,Minnesota,Republican,0,20,20
"Lou, Frey, Jr.",Florida,Republican,0,10,10
Dan Frisa,New York,Republican,0,2,2
"William Frist, H.",Tennessee,Republican,12,0,12
"Harold Froehlich, V.",Wisconsin,Republican,0,2,2
Martin Frost,Texas,Democratic,0,26,26
"Marcia Fudge, L.",Ohio,Democratic,0,13,13
James Fulbright,Arkansas,Democratic,4,2,6
Russ Fulcher,Idaho,Republican,0,2,2
Richard Fulton,Tennessee,Democratic,0,14,14
David Funderburk,North Carolina,Republican,0,2,2
Don Fuqua,Florida,Democratic,0,24,24
Elizabeth Furse,Oregon,Democratic,0,6,6
"Fuster, Commissioner",Puerto Rico,Democratic,0,8,8
Tulsi Gabbard,Hawaii,Democratic,0,8,8
Matt Gaetz,Florida,Republican,0,4,4
Mike Gallagher,Wisconsin,Republican,0,4,4
Elton Gallegly,California,Republican,0,26,26
"Pete Gallego, P.",Texas,Democratic,0,2,2
Ruben Gallego,Arizona,Democratic,0,6,6
"Dean Gallo, A.",New Jersey,Republican,0,10,10
"Robert Gammage, A.",Texas,Democratic,0,2,2
Greg Ganske,Iowa,Republican,0,8,8
John Garamendi,California,Democratic,0,12,12
"Andrew Garbarino, R.",New York,Republican,0,0,0
Jesus Garcia,Illinois,Democratic,0,2,2
Joe Garcia,Florida,Democratic,0,2,2
Mike Garcia,California,Republican,0,1,1
Robert Garcia,New York,Democratic,0,14,14
"Sylvia Garcia, R.",Texas,Democratic,0,2,2
Cory Gardner,Colorado,Republican,6,4,10
E. Garn,Utah,Republican,18,0,18
Scott Garrett,New Jersey,Republican,0,14,14
Thomas Garrett,Virginia,Republican,0,2,2
"Joseph Gaydos, M.",Pennsylvania,Democratic,0,26,26
Sam Gejdenson,Connecticut,Democratic,0,20,20
"George Gekas, W.",Pennsylvania,Republican,0,20,20
"Richard Gephardt, A.",Missouri,Democratic,0,28,28
Pete Geren,Texas,Democratic,0,8,8
Jim Gerlach,Pennsylvania,Republican,0,12,12
"Tom Gettys, S.",South Carolina,Democratic,0,12,12
"Robert Giaimo, N.",Connecticut,Democratic,0,22,22
Greg Gianforte,Montana,Republican,0,4,4
Jim Gibbons,Nevada,Republican,0,10,10
Sam Gibbons,Florida,Democratic,0,34,34
Bob Gibbs,Ohio,Republican,0,10,10
"Christopher Gibson, P.",New York,Republican,0,6,6
Gabrielle Giffords,Arizona,Democratic,0,5,5
"Wayne Gilchrest, T.",Maryland,Republican,0,18,18
"Kirsten Gillibrand, E.",New York,Democratic,12,2,14
"Paul Gillmor, E.",Ohio,Republican,0,18,18
"Benjamin Gilman, A.",New York,Republican,0,30,30
"Carlos Gimenez, A.",Florida,Republican,0,0,0
Phil Gingrey,Georgia,Republican,0,12,12
Newt Gingrich,Georgia,Republican,0,20,20
Bo Ginn,Georgia,Democratic,0,10,10
John Glenn,Ohio,Democratic,24,0,24
Dan Glickman,Kansas,Democratic,0,18,18
Louie Gohmert,Texas,Republican,0,16,16
"Jared Golden, F.",Maine,Democratic,0,2,2
Barry Goldwater,Arizona,Republican,30,0,30
"Barry, Goldwater, Jr.",California,Republican,0,14,14
Jimmy Gomez,California,Democratic,0,4,4
Tony Gonzales,Texas,Republican,0,0,0
Anthony Gonzalez,Ohio,Republican,0,2,2
"Charles Gonzalez, A.",Texas,Democratic,0,14,14
"Henry Gonzalez, B.",Texas,Democratic,0,38,38
Vicente Gonzalez,Texas,Democratic,0,4,4
"Gonzalez-Colon, Commissioner, Jenniffer",Puerto Rico,Republican,0,4,4
Bob Good,Virginia,Republican,0,0,0
Virgil Goode,Virginia,Republican,0,12,12
Lance Gooden,Texas,Republican,0,2,2
Bob Goodlatte,Virginia,Republican,0,26,26
"George Goodling, A.",Pennsylvania,Republican,0,12,12
"William Goodling, F.",Pennsylvania,Republican,0,26,26
"Carte Goodwin, Patrick",West Virginia,Democratic,0,0,0
Bart Gordon,Tennessee,Democratic,0,26,26
"Albert, Gore, Jr.",Tennessee,Democratic,8,8,16
Slade Gorton,Washington,Republican,18,0,18
"Paul Gosar, A.",Arizona,Republican,0,10,10
"Porter Goss, J.",Florida,Republican,0,15,15
Josh Gottheimer,New Jersey,Democratic,0,4,4
Trey Gowdy,South Carolina,Republican,0,8,8
Willis Gradison,Ohio,Republican,0,20,20
Bob Graham,Florida,Democratic,18,0,18
Gwen Graham,Florida,Democratic,0,2,2
Lindsey Graham,South Carolina,Republican,18,8,26
Phil Gramm,Texas,Republican,17,6,23
Rod Grams,Minnesota,Republican,6,2,8
Fred Grandy,Iowa,Republican,0,8,8
Kay Granger,Texas,Republican,0,24,24
Bill Grant,Florida,Republican,0,4,4
Chuck Grassley,Iowa,Republican,40,6,46
"Ella Grasso, T.",Connecticut,Democratic,0,4,4
Mike Gravel,Alaska,Democratic,12,0,12
Garret Graves,Louisiana,Republican,0,6,6
Sam Graves,Missouri,Republican,0,20,20
Tom Graves,Georgia,Republican,0,10,10
"Kenneth Gray, J.",Illinois,Democratic,0,24,24
William Gray,Pennsylvania,Democratic,0,14,14
Alan Grayson,Florida,Democratic,0,6,6
Al Green,Texas,Democratic,0,16,16
Edith Green,Oregon,Democratic,0,20,20
Gene Green,Texas,Democratic,0,26,26
Mark Green,Wisconsin,Republican,0,8,8
"Mark Green, E.",Tennessee,Republican,0,2,2
"S. Green, William",New York,Republican,0,16,16
"William Green, J.",Pennsylvania,Democratic,0,14,14
"Marjorie Greene, Taylor",Georgia,Republican,0,0,0
"James Greenwood, C.",Pennsylvania,Republican,0,12,12
Judd Gregg,New Hampshire,Republican,18,8,26
"Robert Griffin, P.",Michigan,Republican,6,8,14
Tim Griffin,Arkansas,Republican,0,4,4
"H. Griffith, Morgan",Virginia,Republican,0,10,10
Parker Griffith,Alabama,Republican,0,2,2
"Martha Griffiths, W.",Michigan,Democratic,0,20,20
"Raul Grijalva, M.",Arizona,Democratic,0,18,18
"Michael Grimm, G.",New York,Republican,0,4,4
"Wayne Grisham, R.",California,Republican,0,4,4
"H. Gross, R.",Iowa,Republican,0,26,26
"John Grotberg, E.",Illinois,Republican,0,2,2
Glenn Grothman,Wisconsin,Republican,0,6,6
James Grover,New York,Republican,0,12,12
Felix Grucci,New York,Republican,0,2,2
"Frank Guarini, J.",New Jersey,Democratic,0,14,14
"Charles Gubser, S.",California,Republican,0,22,22
Gilbert Gude,Maryland,Republican,0,10,10
"V. Gudger, Lamar",North Carolina,Democratic,0,4,4
Michael Guest,Mississippi,Republican,0,2,2
"Frank Guinta, C.",New Hampshire,Republican,0,4,4
Steve Gunderson,Wisconsin,Republican,0,16,16
Bill Gunter,Florida,Democratic,0,2,2
"Edward Gurney, J.",Florida,Republican,2,6,8
Brett Guthrie,Kentucky,Republican,0,12,12
"Luis Gutierrez, V.",Illinois,Democratic,0,26,26
Gil Gutknecht,Minnesota,Republican,0,12,12
Tennyson Guyer,Ohio,Republican,0,10,10
"Debra Haaland, A.",New Mexico,Democratic,0,2,2
"Kay Hagan, R.",North Carolina,Democratic,6,0,6
Jim Hagedorn,Minnesota,Republican,0,2,2
"Thomas Hagedorn, M.",Minnesota,Republican,0,8,8
Chuck Hagel,Nebraska,Republican,12,0,12
Bill Hagerty,Tennessee,Republican,0,0,0
Janice Hahn,California,Democratic,0,6,6
"James Haley, A.",Florida,Democratic,0,24,24
"John Hall, J.",New York,Democratic,0,4,4
Katie Hall,Indiana,Democratic,0,4,4
Kwanza Hall,Georgia,Democratic,0,1,1
"Ralph Hall, M.",Texas,Republican,0,34,34
Sam Hall,Texas,Democratic,0,12,12
"Tim Hall, L.",Illinois,Democratic,0,2,2
"Tony Hall, P.",Ohio,Democratic,0,23,23
"Deborah Halvorson, L.",Illinois,Democratic,0,2,2
Dan Hamburg,California,Democratic,0,2,2
"Lee Hamilton, H.",Indiana,Democratic,0,34,34
"John Hammerschmidt, P.",Arkansas,Republican,0,26,26
Colleen Hanabusa,Hawaii,Democratic,0,8,8
"Kent Hance, R.",Texas,Democratic,0,6,6
Mel Hancock,Missouri,Republican,0,8,8
"Karen Handel, C.",Georgia,Republican,0,2,2
"James Hanley, M.",New York,Democratic,0,16,16
"Richard Hanna, L.",New York,Republican,0,6,6
"Richard Hanna, T.",California,Democratic,0,12,12
"Mark Hannaford, W.",California,Democratic,0,4,4
"Robert Hanrahan, P.",Illinois,Republican,0,2,2
"Clifford Hansen, P.",Wyoming,Republican,12,0,12
"George Hansen, V.",Idaho,Republican,0,14,14
"James Hansen, V.",Utah,Republican,0,22,22
"Julia Hansen, Butler",Washington,Democratic,0,16,16
Orval Hansen,Idaho,Republican,0,6,6
Josh Harder,California,Democratic,0,2,2
Cresent Hardy,Nevada,Republican,0,2,2
Phil Hare,Illinois,Democratic,0,4,4
Tom Harkin,Iowa,Democratic,30,10,40
Jane Harman,California,Democratic,0,16,16
Gregg Harper,Mississippi,Republican,0,10,10
"Michael Harrington, J.",Massachusetts,Democratic,0,10,10
Andy Harris,Maryland,Republican,0,10,10
Claude Harris,Alabama,Democratic,0,6,6
Herbert Harris,Virginia,Democratic,0,6,6
"Kamala Harris, D.",California,Democratic,4,0,4
Katherine Harris,Florida,Republican,0,4,4
Frank Harrison,Pennsylvania,Democratic,0,2,2
"William Harsha, H.",Ohio,Republican,0,20,20
Diana Harshbarger,Tennessee,Republican,0,0,0
"Gary Hart, W.",Colorado,Democratic,12,0,12
"Melissa Hart, A.",Pennsylvania,Republican,0,6,6
"Philip Hart, A.",Michigan,Democratic,18,0,18
Vance Hartke,Indiana,Democratic,18,0,18
"Thomas Hartnett, F.",South Carolina,Republican,0,6,6
Vicky Hartzler,Missouri,Republican,0,10,10
James Harvey,Michigan,Republican,0,14,14
"Floyd Haskell, K.",Colorado,Democratic,6,0,6
"Margaret Hassan, Wood",New Hampshire,Democratic,4,0,4
"J. Hastert, Dennis",Illinois,Republican,0,20,20
"Alcee Hastings, L.",Florida,Democratic,0,28,28
Doc Hastings,Washington,Republican,0,20,20
"James Hastings, F.",New York,Republican,0,8,8
"Orrin Hatch, G.",Utah,Republican,42,0,42
Charles Hatcher,Georgia,Democratic,0,12,12
"Mark Hatfield, O.",Oregon,Republican,30,0,30
Paul Hatfield,Montana,Democratic,2,0,2
"William Hathaway, D.",Maine,Democratic,6,8,14
"Augustus Hawkins, F.",California,Democratic,0,28,28
Paula Hawkins,Florida,Republican,6,0,6
Josh Hawley,Missouri,Republican,2,0,2
"Samuel Hayakawa, Ichiye",California,Republican,6,0,6
"Charles Hayes, A.",Illinois,Democratic,0,10,10
Jahana Hayes,Connecticut,Democratic,0,2,2
"James Hayes, A.",Louisiana,Republican,0,10,10
"Philip Hayes, H.",Indiana,Democratic,0,2,2
Robin Hayes,North Carolina,Republican,0,10,10
"Wayne Hays, L.",Ohio,Democratic,0,28,28
"J. Hayworth, D.",Arizona,Republican,0,12,12
Nan Hayworth,New York,Republican,0,2,2
"F. Hebert, Edward",Louisiana,Democratic,0,36,36
Ken Hechler,West Virginia,Democratic,0,18,18
Chic Hecht,Nevada,Republican,6,0,6
Denny Heck,Washington,Democratic,0,8,8
"Joseph Heck, J.",Nevada,Republican,0,6,6
"Margaret Heckler, M.",Massachusetts,Republican,0,16,16
Joel Hefley,Colorado,Republican,0,20,20
Howell Heflin,Alabama,Democratic,18,0,18
W. Hefner,North Carolina,Democratic,0,24,24
Cecil Heftel,Hawaii,Democratic,0,10,10
Frederick Heineman,North Carolina,Republican,0,2,2
Martin Heinrich,New Mexico,Democratic,8,4,12
John Heinz,Pennsylvania,Republican,16,6,22
Heidi Heitkamp,North Dakota,Democratic,6,0,6
Dean Heller,Nevada,Republican,8,4,12
Jesse Helms,North Carolina,Republican,30,0,30
Henry Helstoski,New Jersey,Democratic,0,12,12
"David Henderson, N.",North Carolina,Democratic,0,16,16
Bill Hendon,North Carolina,Republican,0,4,4
"Paul Henry, B.",Michigan,Republican,0,10,10
Jeb Hensarling,Texas,Republican,0,16,16
Wally Herger,California,Republican,0,26,26
Kevin Hern,Oklahoma,Republican,0,3,3
Yvette Herrell,New Mexico,Republican,0,0,0
"Beutler, Herrera, Jaime",Washington,Republican,0,10,10
"Sandlin, Herseth, Stephanie",South Dakota,Democratic,0,7,7
"Dennis Hertel, M.",Michigan,Democratic,0,12,12
"Jody Hice, B.",Georgia,Republican,0,6,6
"John Hickenlooper, W.",Colorado,Democratic,0,0,0
"Floyd Hicks, V.",Washington,Democratic,0,12,12
Brian Higgins,New York,Democratic,0,16,16
Clay Higgins,Louisiana,Republican,0,4,4
"Jack Hightower, E.",Texas,Democratic,0,10,10
"John Hiler, Patrick",Indiana,Republican,0,10,10
"Baron Hill, P.",Indiana,Democratic,0,10,10
"J. Hill, French",Arkansas,Republican,0,6,6
Katie Hill,California,Democratic,0,0,0
Rick Hill,Montana,Republican,0,4,4
Van Hilleary,Tennessee,Republican,0,8,8
"Earl Hilliard, F.",Alabama,Democratic,0,10,10
"Elwood Hillis, H.",Indiana,Republican,0,16,16
"James Himes, A.",Connecticut,Democratic,0,12,12
"Maurice Hinchey, D.",New York,Democratic,0,20,20
Ruben Hinojosa,Texas,Democratic,0,20,20
"Andrew Hinshaw, J.",California,Republican,0,4,4
Ashley Hinson,Iowa,Republican,0,0,0
"Jon Hinson, C.",Mississippi,Republican,0,4,4
"Mazie Hirono, K.",Hawaii,Democratic,8,6,14
Peter Hoagland,Nebraska,Democratic,0,6,6
"David Hobson, L.",Ohio,Republican,0,18,18
"George Hochbrueckner, J.",New York,Democratic,0,8,8
"Kathleen Hochul, C.",New York,Democratic,0,2,2
"Paul Hodes, W.",New Hampshire,Democratic,0,4,4
"Kaneaster, Hodges, Jr.",Arkansas,Democratic,2,0,2
"Joseph Hoeffel, M.",Pennsylvania,Democratic,0,6,6
Peter Hoekstra,Michigan,Republican,0,18,18
John Hoeven,North Dakota,Republican,10,0,10
"Lawrence Hogan, J.",Maryland,Republican,0,6,6
"Martin Hoke, R.",Ohio,Republican,0,4,4
Tim Holden,Pennsylvania,Democratic,0,20,20
George Holding,North Carolina,Republican,0,8,8
Chet Holifield,California,Democratic,0,6,6
"Kenneth Holland, L.",South Carolina,Democratic,0,8,8
"Harold Hollenbeck, C.",New Jersey,Republican,0,6,6
"Ernest Hollings, F.",South Carolina,Democratic,40,0,40
Trey Hollingsworth,Indiana,Republican,0,4,4
Clyde Holloway,Louisiana,Republican,0,6,6
"Marjorie Holt, S.",Maryland,Republican,0,14,14
Rush Holt,New Jersey,Democratic,0,16,16
Elizabeth Holtzman,New York,Democratic,0,8,8
"Michael Honda, M.",California,Democratic,0,16,16
Darlene Hooley,Oregon,Democratic,0,12,12
"Larry Hopkins, J.",Kentucky,Republican,0,14,14
"Joan Horn, Kelly",Missouri,Democratic,0,2,2
"Kendra Horn, S.",Oklahoma,Democratic,0,2,2
Stephen Horn,California,Republican,0,10,10
Steven Horsford,Nevada,Democratic,0,4,4
"Frank Horton, J.",New York,Republican,0,30,30
Craig Hosmer,California,Republican,0,22,22
"John Hostettler, N.",Indiana,Republican,0,12,12
Amo Houghton,New York,Republican,0,18,18
Chrissy Houlahan,Pennsylvania,Democratic,0,2,2
"James Howard, J.",New Jersey,Democratic,0,24,24
Allan Howe,Utah,Democratic,0,2,2
"Steny Hoyer, H.",Maryland,Democratic,0,40,40
"Roman Hruska, L.",Nebraska,Republican,24,0,24
"Carroll, Hubbard, Jr.",Kentucky,Democratic,0,18,18
"Robert Huber, J.",Michigan,Republican,0,2,2
Thomas Huckaby,Louisiana,Democratic,0,16,16
"Walter Huddleston, (Dee)",Kentucky,Democratic,12,0,12
William Hudnut,Indiana,Republican,0,2,2
Richard Hudson,North Carolina,Republican,0,8,8
Tim Huelskamp,Kansas,Republican,0,6,6
Michael Huffington,California,Republican,0,2,2
Jared Huffman,California,Democratic,0,8,8
"Harold Hughes, E.",Iowa,Democratic,6,0,6
"William Hughes, J.",New Jersey,Democratic,0,20,20
Bill Huizenga,Michigan,Republican,0,10,10
"Kenny Hulshof, C.",Missouri,Republican,0,12,12
Randy Hultgren,Illinois,Republican,0,8,8
"Gordon Humphrey, J.",New Hampshire,Republican,12,0,12
"Hubert Humphrey, H.",Minnesota,Democratic,24,0,24
Muriel Humphrey,Minnesota,Democratic,2,0,2
"William Hungate, L.",Missouri,Democratic,0,14,14
"John Hunt, E.",New Jersey,Republican,0,8,8
Duncan Hunter,California,Republican,0,28,28
"Duncan Hunter, D.",California,Republican,0,11,11
Will Hurd,Texas,Republican,0,6,6
Robert Hurt,Virginia,Republican,0,6,6
Asa Hutchinson,Arkansas,Republican,0,4,4
Edward Hutchinson,Michigan,Republican,0,14,14
"John Hutchinson, G.",West Virginia,Democratic,0,2,2
Tim Hutchinson,Arkansas,Republican,6,4,10
"Kay Hutchison, Bailey",Texas,Republican,20,0,20
Earl Hutto,Florida,Democratic,0,16,16
"Henry Hyde, J.",Illinois,Republican,0,32,32
Cindy Hyde-Smith,Mississippi,Republican,3,0,3
"Richard Ichord, H.",Missouri,Democratic,0,20,20
Bob Inglis,South Carolina,Republican,0,12,12
"James Inhofe, M.",Oklahoma,Republican,27,8,35
"Daniel Inouye, K.",Hawaii,Democratic,49,4,53
Jay Inslee,Washington,Democratic,0,15,15
"Andrew Ireland, P.",Florida,Republican,0,16,16
Johnny Isakson,Georgia,Republican,14,6,20
Steve Israel,New York,Democratic,0,16,16
"Darrell Issa, E.",California,Republican,0,18,18
Ernest Istook,Oklahoma,Republican,0,14,14
"Lee, Jackson, Sheila",Texas,Democratic,0,26,26
"Henry Jackson, M.",Washington,Democratic,32,12,44
Jesse Jackson,Illinois,Democratic,0,17,17
Ronny Jackson,Texas,Republican,0,0,0
"Andrew, Jacobs, Jr.",Indiana,Democratic,0,30,30
Chris Jacobs,New York,Republican,0,1,1
Sara Jacobs,California,Democratic,0,0,0
"Craig James, T.",Florida,Republican,0,4,4
"William Janklow, J.",South Dakota,Republican,0,1,1
John Jarman,Oklahoma,Democratic,0,26,26
"Jacob Javits, K.",New York,Republican,24,8,32
Pramila Jayapal,Washington,Democratic,0,4,4
"William Jefferson, J.",Louisiana,Democratic,0,18,18
"James Jeffords, M.",Vermont,Independent,18,14,32
"Hakeem Jeffries, S.",New York,Democratic,0,8,8
Jim Jeffries,Kansas,Republican,0,4,4
"Edgar Jenkins, L.",Georgia,Democratic,0,16,16
"Evan Jenkins, H.",West Virginia,Republican,0,3,3
Lynn Jenkins,Kansas,Republican,0,10,10
"William Jenkins, L.",Tennessee,Republican,0,10,10
John Jenrette,South Carolina,Democratic,0,6,6
"Roger Jepsen, W.",Iowa,Republican,6,0,6
Bobby Jindal,Louisiana,Republican,0,3,3
Mike Johanns,Nebraska,Republican,6,0,6
Christopher John,Louisiana,Democratic,0,8,8
"Albert Johnson, W.",Pennsylvania,Republican,0,14,14
Bill Johnson,Ohio,Republican,0,10,10
Don Johnson,Georgia,Democratic,0,2,2
Dusty Johnson,South Dakota,Republican,0,2,2
"Eddie Johnson, Bernice",Texas,Democratic,0,28,28
"Harold Johnson, T.",California,Democratic,0,22,22
Henry Johnson,Georgia,Democratic,0,14,14
James Johnson,Colorado,Republican,0,8,8
"Jay Johnson, W.",Wisconsin,Democratic,0,2,2
Mike Johnson,Louisiana,Republican,0,4,4
"Nancy Johnson, L.",Connecticut,Republican,0,24,24
Ron Johnson,Wisconsin,Republican,10,0,10
Sam Johnson,Texas,Republican,0,28,28
Tim Johnson,South Dakota,Democratic,18,10,28
"Timothy Johnson, V.",Illinois,Republican,0,12,12
"Eugene Johnston, (Gene)",North Carolina,Republican,0,2,2
Harry Johnston,Florida,Democratic,0,8,8
"J. Johnston, Bennett",Louisiana,Democratic,26,0,26
"David Jolly, W.",Florida,Republican,0,3,3
Ben Jones,Georgia,Democratic,0,4,4
Brenda Jones,Michigan,Democratic,0,1,1
Doug Jones,Alabama,Democratic,3,0,3
Ed Jones,Tennessee,Democratic,0,20,20
"James Jones, R.",Oklahoma,Democratic,0,14,14
Mondaire Jones,New York,Democratic,0,0,0
Robert Jones,Alabama,Democratic,0,30,30
"Stephanie Jones, Tubbs",Ohio,Democratic,0,9,9
"Walter Jones, B.",North Carolina,Democratic,0,28,28
Walter Jones,North Carolina,Republican,0,24,24
Jim Jontz,Indiana,Democratic,0,6,6
Barbara Jordan,Texas,Democratic,0,6,6
Jim Jordan,Ohio,Republican,0,14,14
"David Joyce, P.",Ohio,Republican,0,8,8
John Joyce,Pennsylvania,Republican,0,2,2
Steve Kagen,Wisconsin,Democratic,0,4,4
Kaiali'i Kahele,Hawaii,Democratic,0,0,0
Tim Kaine,Virginia,Democratic,8,0,8
"Paul Kanjorski, E.",Pennsylvania,Democratic,0,26,26
Marcy Kaptur,Ohio,Democratic,0,38,38
"David Karnes, K.",Nebraska,Republican,2,0,2
"Joseph Karth, E.",Minnesota,Democratic,0,18,18
"John Kasich, R.",Ohio,Republican,0,18,18
"Nancy Kassebaum, Landon",Kansas,Republican,18,0,18
Robert Kasten,Wisconsin,Republican,12,4,16
"Robert Kastenmeier, W.",Wisconsin,Democratic,0,32,32
John Katko,New York,Republican,0,6,6
"Edward Kaufman, E.",Delaware,Democratic,1,0,1
"Abraham, Kazen, Jr.",Texas,Democratic,0,18,18
"William Keating, J.",Ohio,Republican,0,4,4
"William Keating, R.",Massachusetts,Democratic,0,10,10
Fred Keller,Pennsylvania,Republican,0,2,2
Ric Keller,Florida,Republican,0,8,8
Mark Kelly,Arizona,Democratic,1,0,1
Mike Kelly,Pennsylvania,Republican,0,10,10
Richard Kelly,Florida,Republican,0,6,6
"Robin Kelly, L.",Illinois,Democratic,0,8,8
"Sue Kelly, W.",New York,Republican,0,12,12
Trent Kelly,Mississippi,Republican,0,6,6
Jack Kemp,New York,Republican,0,18,18
Dirk Kempthorne,Idaho,Republican,6,0,6
"Edward Kennedy, M.",Massachusetts,Democratic,48,0,48
John Kennedy,Louisiana,Republican,4,0,4
Joseph Kennedy,Massachusetts,Democratic,0,12,12
Joseph Kennedy,Massachusetts,Democratic,0,8,8
"Mark Kennedy, R.",Minnesota,Republican,0,6,6
"Patrick Kennedy, J.",Rhode Island,Democratic,0,16,16
"Barbara Kennelly, B.",Connecticut,Democratic,0,18,18
"Brian Kerns, D.",Indiana,Republican,0,2,2
"J. Kerrey, Robert",Nebraska,Democratic,12,0,12
"John Kerry, F.",Massachusetts,Democratic,28,0,28
"William Ketchum, M.",California,Republican,0,6,6
"Martha Keys, E.",Kansas,Democratic,0,4,4
Ro Khanna,California,Democratic,0,4,4
"Ruben Kihuen, J.",Nevada,Democratic,0,2,2
"Dale Kildee, E.",Michigan,Democratic,0,36,36
"Daniel Kildee, T.",Michigan,Democratic,0,8,8
Derek Kilmer,Washington,Democratic,0,8,8
"Carolyn Kilpatrick, C.",Michigan,Democratic,0,14,14
"Mary Kilroy, Jo",Ohio,Democratic,0,2,2
Andy Kim,New Jersey,Democratic,0,2,2
Jay Kim,California,Republican,0,6,6
Young Kim,California,Republican,0,0,0
Ron Kind,Wisconsin,Democratic,0,24,24
"Thomas Kindness, N.",Ohio,Republican,0,12,12
Angus King,Maine,Independent,8,0,8
"Carleton King, J.",New York,Republican,0,14,14
"Peter King, T.",New York,Republican,0,28,28
Steve King,Iowa,Republican,0,18,18
Jack Kingston,Georgia,Republican,0,22,22
Adam Kinzinger,Illinois,Republican,0,10,10
"Mark Kirk, Steven",Illinois,Republican,7,9,16
Paul Kirk,Massachusetts,Democratic,1,0,1
Ann Kirkpatrick,Arizona,Democratic,0,4,4
Larry Kissell,North Carolina,Democratic,0,4,4
"Gerald Kleczka, D.",Wisconsin,Democratic,0,22,22
"Herbert Klein, C.",New Jersey,Democratic,0,2,2
Ron Klein,Florida,Democratic,0,4,4
John Kline,Minnesota,Republican,0,14,14
Ron Klink,Pennsylvania,Democratic,0,8,8
Amy Klobuchar,Minnesota,Democratic,14,0,14
"John Kluczynski, C.",Illinois,Democratic,0,26,26
"Scott Klug, L.",Wisconsin,Republican,0,8,8
Stephen Knight,California,Republican,0,4,4
Joe Knollenberg,Michigan,Republican,0,16,16
"Edward Koch, I.",New York,Democratic,0,10,10
Ray Kogovsek,Colorado,Democratic,0,6,6
Herb Kohl,Wisconsin,Democratic,24,0,24
Jim Kolbe,Arizona,Republican,0,22,22
"Joseph Kolter, P.",Pennsylvania,Democratic,0,10,10
"Ernest Konnyu, L.",California,Republican,0,2,2
Mike Kopetski,Oregon,Democratic,0,4,4
"Suzanne Kosmas, M.",Florida,Democratic,0,2,2
"Peter Kostmayer, H.",Pennsylvania,Democratic,0,14,14
Ken Kramer,Colorado,Republican,0,8,8
"Frank, Kratovil, Jr.",Maryland,Democratic,0,2,2
"John Krebs, H.",California,Democratic,0,4,4
Mike Kreidler,Washington,Democratic,0,2,2
Raja Krishnamoorthi,Illinois,Democratic,0,4,4
"Robert Krueger, C.",Texas,Democratic,2,4,6
"Dennis Kucinich, J.",Ohio,Democratic,0,16,16
John Kuhl,New York,Republican,0,4,4
"Ann Kuster, M.",New Hampshire,Democratic,0,8,8
David Kustoff,Tennessee,Republican,0,4,4
"Dan Kuykendall, H.",Tennessee,Republican,0,8,8
"Steven Kuykendall, T.",California,Republican,0,2,2
Jon Kyl,Arizona,Republican,19,8,27
"Peter Kyros, N.",Maine,Democratic,0,8,8
"Raul Labrador, R.",Idaho,Republican,0,8,8
"John LaFalce, J.",New York,Democratic,0,28,28
"Robert Lagomarsino, J.",California,Republican,0,20,20
Darin LaHood,Illinois,Republican,0,6,6
Ray LaHood,Illinois,Republican,0,14,14
Doug LaMalfa,California,Republican,0,8,8
Conor Lamb,Pennsylvania,Democratic,0,3,3
Doug Lamborn,Colorado,Republican,0,14,14
Nick Lampson,Texas,Democratic,0,10,10
"H. Lancaster, Martin",North Carolina,Democratic,0,8,8
Leonard Lance,New Jersey,Republican,0,10,10
"Earl Landgrebe, F.",Indiana,Republican,0,6,6
"Mary Landrieu, L.",Louisiana,Democratic,18,0,18
"Phil Landrum, M.",Georgia,Democratic,0,24,24
"Jeffrey Landry, M.",Louisiana,Republican,0,2,2
"James Langevin, R.",Rhode Island,Democratic,0,20,20
James Lankford,Oklahoma,Republican,6,4,10
Tom Lantos,California,Democratic,0,27,27
Steve Largent,Oklahoma,Republican,0,9,9
Larry LaRocco,Idaho,Democratic,0,4,4
Rick Larsen,Washington,Democratic,0,20,20
"John Larson, B.",Connecticut,Democratic,0,22,22
Tom Latham,Iowa,Republican,0,20,20
"Steven LaTourette, C.",Ohio,Republican,0,18,18
"Delbert Latta, L.",Ohio,Republican,0,30,30
"Robert Latta, E.",Ohio,Republican,0,14,14
Jake LaTurner,Kansas,Republican,0,0,0
Greg Laughlin,Texas,Republican,0,8,8
"Frank Lautenberg, R.",New Jersey,Democratic,28,0,28
"Brenda Lawrence, L.",Michigan,Democratic,0,6,6
"Al, Lawson, Jr.",Florida,Democratic,0,4,4
"Paul Laxalt, D.",Nevada,Republican,14,0,14
Rick Lazio,New York,Republican,0,8,8
Claude Leach,Louisiana,Democratic,0,2,2
"James Leach, A.",Iowa,Republican,0,30,30
"Patrick Leahy, J.",Vermont,Democratic,46,0,46
Marvin Leath,Texas,Democratic,0,12,12
John LeBoutillier,New York,Republican,0,2,2
"Raymond Lederer, F.",Pennsylvania,Democratic,0,6,6
Barbara Lee,California,Democratic,0,24,24
"Christopher Lee, J.",New York,Republican,0,2,2
"Gary Lee, A.",New York,Republican,0,4,4
Mike Lee,Utah,Republican,10,0,10
Susie Lee,Nevada,Democratic,0,2,2
"Joseph LeFante, A.",New Jersey,Democratic,0,2,2
"Fernandez, Leger, Teresa",New Mexico,Democratic,0,0,0
"Robert Leggett, L.",California,Democratic,0,16,16
"Richard Lehman, H.",California,Democratic,0,12,12
William Lehman,Florida,Democratic,0,20,20
Mickey Leland,Texas,Democratic,0,12,12
"George LeMieux, S.",Florida,Republican,2,0,2
"Norman Lent, F.",New York,Republican,0,22,22
Debbie Lesko,Arizona,Republican,0,3,3
Julia Letlow,Louisiana,Republican,0,0,0
Andy Levin,Michigan,Democratic,0,2,2
Carl Levin,Michigan,Democratic,36,0,36
Mike Levin,California,Democratic,0,2,2
"Sander Levin, M.",Michigan,Democratic,0,36,36
Mel Levine,California,Democratic,0,10,10
"Elliott Levitas, H.",Georgia,Democratic,0,10,10
"David Levy, A.",New York,Republican,0,2,2
Jason Lewis,Minnesota,Republican,0,2,2
Jerry Lewis,California,Republican,0,34,34
John Lewis,Georgia,Democratic,0,33,33
Ron Lewis,Kentucky,Republican,0,16,16
"Thomas Lewis, F.",Florida,Republican,0,12,12
"Joseph Lieberman, I.",Connecticut,Independent Democrat,24,0,24
Ted Lieu,California,Democratic,0,6,6
Jim Lightfoot,Iowa,Republican,0,12,12
"Blanche Lincoln, L.",Arkansas,Democratic,12,4,16
John Linder,Georgia,Republican,0,18,18
Daniel Lipinski,Illinois,Democratic,0,16,16
"William Lipinski, O.",Illinois,Democratic,0,22,22
Jerry Litton,Missouri,Democratic,0,4,4
Bob Livingston,Louisiana,Republican,0,24,24
"James Lloyd, F.",California,Democratic,0,6,6
Marilyn Lloyd,Tennessee,Democratic,0,20,20
"Frank LoBiondo, A.",New Jersey,Republican,0,24,24
David Loebsack,Iowa,Democratic,0,14,14
Kelly Loeffler,Georgia,Republican,1,0,1
Tom Loeffler,Texas,Republican,0,8,8
Zoe Lofgren,California,Democratic,0,26,26
Billy Long,Missouri,Republican,0,10,10
Cathy Long,Louisiana,Democratic,0,2,2
"Clarence Long, D.",Maryland,Democratic,0,22,22
"Gillis Long, W.",Louisiana,Democratic,0,16,16
"Jill Long, L.",Indiana,Democratic,0,6,6
"Russell Long, B.",Louisiana,Democratic,40,0,40
James Longley,Maine,Republican,0,2,2
Trent Lott,Mississippi,Republican,18,16,34
Barry Loudermilk,Georgia,Republican,0,6,6
"Mia Love, B.",Utah,Republican,0,4,4
"Alan Lowenthal, S.",California,Democratic,0,8,8
Bill Lowery,California,Republican,0,12,12
"Nita Lowey, M.",New York,Democratic,0,32,32
Mike Lowry,Washington,Democratic,0,10,10
"Frank Lucas, D.",Oklahoma,Republican,0,28,28
Ken Lucas,Kentucky,Democratic,0,6,6
Blaine Luetkemeyer,Missouri,Republican,0,12,12
"Richard Lugar, G.",Indiana,Republican,36,0,36
"Grisham, Lujan, Michelle",New Mexico,Democratic,0,6,6
"Ben Lujan, Ray",New Mexico,Democratic,0,12,12
"Manuel, Lujan, Jr.",New Mexico,Republican,0,20,20
Charles Luken,Ohio,Democratic,0,2,2
"Thomas Luken, A.",Ohio,Democratic,0,16,16
"Donald Lukens, E.",Ohio,Republican,0,8,8
"Cynthia Lummis, M.",Wyoming,Republican,0,8,8
"Stanley Lundine, N.",New York,Democratic,0,12,12
"Daniel Lungren, E.",California,Republican,0,18,18
"Elaine Luria, G.",Virginia,Democratic,0,2,2
Bill Luther,Minnesota,Democratic,0,8,8
"Stephen Lynch, F.",Massachusetts,Democratic,0,20,20
Thomas MacArthur,New Jersey,Republican,0,4,4
"Torbert Macdonald, H.",Massachusetts,Democratic,0,22,22
Nancy Mace,South Carolina,Republican,0,0,0
"Ronald Machtley, K.",Rhode Island,Republican,0,6,6
Connie Mack,Florida,Republican,0,8,8
"Connie, Mack, III",Florida,Republican,12,6,18
Buddy MacKay,Florida,Democratic,0,6,6
"Ray Madden, J.",Indiana,Democratic,0,8,8
"Edward Madigan, R.",Illinois,Republican,0,20,20
"Daniel Maffei, B.",New York,Democratic,0,4,4
"Warren Magnuson, G.",Washington,Democratic,36,6,42
Andrew Maguire,New Jersey,Democratic,0,6,6
"George Mahon, H.",Texas,Democratic,0,44,44
Tim Mahoney,Florida,Democratic,0,2,2
"William Mailliard, S.",California,Republican,0,22,22
"Denise Majette, L.",Georgia,Democratic,0,2,2
Tom Malinowski,New Jersey,Democratic,0,2,2
"Richard Mallary, W.",Vermont,Republican,0,4,4
Nicole Malliotakis,New York,Republican,0,0,0
"Carolyn Maloney, B.",New York,Democratic,0,28,28
"James Maloney, H.",Connecticut,Democratic,0,6,6
"Sean Maloney, Patrick",New York,Democratic,0,8,8
"Joe, Manchin, III",West Virginia,Democratic,11,0,11
David Mann,Ohio,Democratic,0,2,2
"James Mann, R.",South Carolina,Democratic,0,10,10
Tracey Mann,Kansas,Republican,0,0,0
"Kathy Manning, E.",North Carolina,Democratic,0,0,0
Mike Mansfield,Montana,Democratic,24,10,34
"Thomas Manton, J.",New York,Democratic,0,14,14
"Donald Manzullo, A.",Illinois,Republican,0,20,20
"Joseph Maraziti, J.",New Jersey,Republican,0,2,2
Kenny Marchant,Texas,Republican,0,16,16
Marjorie Margolies-Mezvinsky,Pennsylvania,Democratic,0,2,2
Tom Marino,Pennsylvania,Republican,0,8,8
Betsy Markey,Colorado,Democratic,0,2,2
"Edward Markey, J.",Massachusetts,Democratic,8,36,44
"Marc Marks, L.",Pennsylvania,Republican,0,6,6
Ron Marlenee,Montana,Republican,0,16,16
"David Marriott, Daniel",Utah,Republican,0,8,8
Jim Marshall,Georgia,Democratic,0,8,8
"Roger Marshall, W.",Kansas,Republican,0,4,4
"David Martin, O'B.",New York,Republican,0,12,12
"David Martin, T.",Nebraska,Republican,0,14,14
"James Martin, G.",North Carolina,Republican,0,12,12
"Lynn Martin, M.",Illinois,Republican,0,10,10
"Matthew Martinez, G.",California,Republican,0,20,20
Mel Martinez,Florida,Republican,4,0,4
"William Martini, J.",New Jersey,Republican,0,2,2
Frank Mascara,Pennsylvania,Democratic,0,8,8
Eric Massa,New York,Democratic,0,1,1
Thomas Massie,Kentucky,Republican,0,9,9
"Brian Mast, J.",Florida,Republican,0,4,4
Jim Matheson,Utah,Democratic,0,14,14
Harlan Mathews,Tennessee,Democratic,2,0,2
Charles Mathias,Maryland,Republican,14,8,22
Robert Mathias,California,Republican,0,8,8
Dawson Mathis,Georgia,Democratic,0,10,10
"Doris Matsui, O.",California,Democratic,0,16,16
"Robert Matsui, T.",California,Democratic,0,25,25
"Spark Matsunaga, M.",Hawaii,Democratic,14,14,28
Mack Mattingly,Georgia,Republican,6,0,6
"James Mattox, A.",Texas,Democratic,0,6,6
Nicholas Mavroules,Massachusetts,Democratic,0,14,14
Wiley Mayne,Iowa,Republican,0,8,8
"Romano Mazzoli, L.",Kentucky,Democratic,0,24,24
Ben McAdams,Utah,Democratic,0,2,2
"Vance McAllister, M.",Louisiana,Republican,0,2,2
Lucy McBath,Georgia,Democratic,0,2,2
John McCain,Arizona,Republican,31,4,35
Alfred McCandless,California,Republican,0,12,12
Carolyn McCarthy,New York,Democratic,0,18,18
Karen McCarthy,Missouri,Democratic,0,10,10
Kevin McCarthy,California,Republican,0,14,14
Claire McCaskill,Missouri,Democratic,12,0,12
"Michael McCaul, T.",Texas,Republican,0,16,16
"Lisa McClain, C.",Michigan,Republican,0,0,0
"John McClellan, L.",Arkansas,Democratic,6,4,10
Tom McClintock,California,Republican,0,12,12
Robert McClory,Illinois,Republican,0,20,20
Frank McCloskey,Indiana,Democratic,0,12,12
Paul McCloskey,California,Republican,0,16,16
"James McClure, A.",Idaho,Republican,18,6,24
"John McCollister, Y.",Nebraska,Republican,0,6,6
Betty McCollum,Minnesota,Democratic,0,20,20
Bill McCollum,Florida,Republican,0,20,20
Mitch McConnell,Kentucky,Republican,36,0,36
Mike McCormack,Washington,Democratic,0,10,10
"Thaddeus McCotter, G.",Michigan,Republican,0,9,9
Jim McCrery,Louisiana,Republican,0,24,24
Dave McCurdy,Oklahoma,Democratic,0,14,14
"Joseph McDade, M.",Pennsylvania,Republican,0,36,36
Jim McDermott,Washington,Democratic,0,28,28
"Lawrence McDonald, P.",Georgia,Democratic,0,10,10
"A. McEachin, Donald",Virginia,Democratic,0,4,4
Bob McEwen,Ohio,Republican,0,12,12
"Robert McEwen, C.",New York,Republican,0,16,16
"John McFall, J.",California,Democratic,0,22,22
"Gale McGee, W.",Wyoming,Democratic,18,0,18
George McGovern,South Dakota,Democratic,18,4,22
"James McGovern, P.",Massachusetts,Democratic,0,24,24
"Raymond McGrath, J.",New York,Republican,0,12,12
Paul McHale,Pennsylvania,Democratic,0,6,6
"Patrick McHenry, T.",North Carolina,Republican,0,16,16
"John McHugh, M.",New York,Republican,0,16,16
"Matthew McHugh, F.",New York,Democratic,0,18,18
Scott McInnis,Colorado,Republican,0,12,12
"David McIntosh, M.",Indiana,Republican,0,6,6
Mike McIntyre,North Carolina,Democratic,0,18,18
"Thomas McIntyre, J.",New Hampshire,Democratic,18,0,18
"K. McKay, Gunn",Utah,Democratic,0,10,10
Howard McKeon,California,Republican,0,22,22
John McKernan,Maine,Republican,0,4,4
"David McKinley, B.",West Virginia,Republican,0,10,10
"Cynthia McKinney, A.",Georgia,Democratic,0,12,12
"Stewart McKinney, B.",Connecticut,Republican,0,18,18
"Michael McMahon, E.",New York,Democratic,0,2,2
"J. McMillan, Alex",North Carolina,Republican,0,10,10
Thomas McMillen,Maryland,Democratic,0,6,6
"Rodgers, McMorris, Cathy",Washington,Republican,0,16,16
Jerry McNerney,California,Democratic,0,14,14
James McNulty,Arizona,Democratic,0,2,2
"Michael McNulty, R.",New York,Democratic,0,20,20
Martha McSally,Arizona,Republican,1,4,5
"Clem McSpadden, Rogers",Oklahoma,Democratic,0,2,2
Mark Meadows,North Carolina,Republican,0,7,7
Lloyd Meeds,Washington,Democratic,0,14,14
"Martin Meehan, T.",Massachusetts,Democratic,0,14,14
Patrick Meehan,Pennsylvania,Republican,0,7,7
"Carrie Meek, P.",Florida,Democratic,0,10,10
"Kendrick Meek, B.",Florida,Democratic,0,8,8
"Gregory Meeks, W.",New York,Democratic,0,24,24
Peter Meijer,Michigan,Republican,0,0,0
Charlie Melancon,Louisiana,Democratic,0,6,6
John Melcher,Montana,Democratic,12,8,20
Robert Menendez,New Jersey,Democratic,15,13,28
Grace Meng,New York,Democratic,0,8,8
Jeff Merkley,Oregon,Democratic,12,0,12
Luke Messer,Indiana,Republican,0,6,6
Jack Metcalf,Washington,Republican,0,6,6
Lee Metcalf,Montana,Democratic,18,8,26
"Ralph Metcalfe, H.",Illinois,Democratic,0,8,8
"Howard Metzenbaum, M.",Ohio,Democratic,20,0,20
Daniel Meuser,Pennsylvania,Republican,0,2,2
Jan Meyers,Kansas,Republican,0,12,12
"Helen Meyner, S.",New Jersey,Democratic,0,4,4
Edward Mezvinsky,Iowa,Democratic,0,4,4
Kweisi Mfume,Maryland,Democratic,0,11,11
"Daniel Mica, Andrew",Florida,Democratic,0,10,10
"John Mica, L.",Florida,Republican,0,24,24
"Michael Michaud, H.",Maine,Democratic,0,12,12
"Robert Michel, H.",Illinois,Republican,0,38,38
"Barbara Mikulski, A.",Maryland,Democratic,30,10,40
"Abner Mikva, J.",Illinois,Democratic,0,10,10
Dale Milford,Texas,Democratic,0,6,6
Juanita Millender-McDonald,California,Democratic,0,12,12
Brad Miller,North Carolina,Democratic,0,10,10
"Candice Miller, S.",Michigan,Republican,0,14,14
"Carol Miller, D.",West Virginia,Republican,0,2,2
"Clarence Miller, E.",Ohio,Republican,0,26,26
Dan Miller,Florida,Republican,0,10,10
"Gary Miller, G.",California,Republican,0,16,16
George Miller,California,Democratic,0,40,40
Jeff Miller,Florida,Republican,0,16,16
"John Miller, R.",Washington,Republican,0,8,8
"Mary Miller, E.",Illinois,Republican,0,0,0
Zell Miller,Georgia,Democratic,5,0,5
Mariannette Miller-Meeks,Iowa,Republican,0,0,0
"Wilbur Mills, D.",Arkansas,Democratic,0,38,38
"William Mills, O.",Maryland,Republican,0,4,4
"Norman Mineta, Y.",California,Democratic,0,22,22
David Minge,Minnesota,Democratic,0,8,8
"Joseph Minish, G.",New Jersey,Democratic,0,22,22
"Patsy Mink, T.",Hawaii,Democratic,0,25,25
Walter Minnick,Idaho,Democratic,0,2,2
"William Minshall, E.",Ohio,Republican,0,20,20
"Donald Mitchell, J.",New York,Republican,0,10,10
"George Mitchell, J.",Maine,Democratic,16,0,16
"Harry Mitchell, E.",Arizona,Democratic,0,4,4
"Parren Mitchell, J.",Maryland,Democratic,0,16,16
Paul Mitchell,Michigan,Independent,0,4,4
Wilmer Mizell,North Carolina,Republican,0,6,6
"John Moakley, Joseph",Massachusetts,Democratic,0,28,28
Toby Moffett,Connecticut,Democratic,0,8,8
Guy Molinari,New York,Republican,0,10,10
Susan Molinari,New York,Republican,0,10,10
"Alan Mollohan, B.",West Virginia,Democratic,0,28,28
"Robert Mollohan, H.",West Virginia,Democratic,0,18,18
"Walter Mondale, F.",Minnesota,Democratic,14,0,14
"David Monson, S.",Utah,Republican,0,2,2
G. Montgomery,Mississippi,Democratic,0,30,30
"Joseph Montoya, M.",New Mexico,Democratic,14,6,20
Jim Moody,Wisconsin,Democratic,0,10,10
"John Moolenaar, R.",Michigan,Republican,0,6,6
"Alexander Mooney, X.",West Virginia,Republican,0,6,6
Barry Moore,Alabama,Republican,0,0,0
"Blake Moore, D.",Utah,Republican,0,0,0
Dennis Moore,Kansas,Democratic,0,12,12
Gwen Moore,Wisconsin,Democratic,0,16,16
"W. Moore, Henson",Louisiana,Republican,0,12,12
"Carlos Moorhead, J.",California,Republican,0,24,24
"William Moorhead, S.",Pennsylvania,Democratic,0,22,22
"James Moran, P.",Virginia,Democratic,0,24,24
Jerry Moran,Kansas,Republican,10,14,24
"Constance Morella, A.",Maryland,Republican,0,16,16
"Joseph Morelle, D.",New York,Democratic,0,3,3
"Robert Morgan, B.",North Carolina,Democratic,6,0,6
"Thomas Morgan, E.",Pennsylvania,Democratic,0,28,28
"Bruce Morrison, A.",Connecticut,Democratic,0,8,8
Sid Morrison,Washington,Republican,0,12,12
Carol Moseley-Braun,Illinois,Democratic,6,0,6
"Charles Mosher, A.",Ohio,Republican,0,16,16
"Frank Moss, E.",Utah,Democratic,18,0,18
"John Moss, E.",California,Democratic,0,26,26
"Ronald Mottl, M.",Ohio,Democratic,0,8,8
Seth Moulton,Massachusetts,Democratic,0,6,6
"Daniel Moynihan, Patrick",New York,Democratic,24,0,24
"Robert Mrazek, J.",New York,Democratic,0,10,10
"Frank Mrvan, J.",Indiana,Democratic,0,0,0
Debbie Mucarsel-Powell,Florida,Democratic,0,2,2
Markwayne Mullin,Oklahoma,Republican,0,8,8
Mick Mulvaney,South Carolina,Republican,0,6,6
"Frank Murkowski, H.",Alaska,Republican,21,0,21
Lisa Murkowski,Alaska,Republican,18,0,18
"Austin Murphy, J.",Pennsylvania,Democratic,0,18,18
Christopher Murphy,Connecticut,Democratic,8,6,14
Gregory Murphy,North Carolina,Republican,0,2,2
"John Murphy, M.",New York,Democratic,0,18,18
"Morgan Murphy, F.",Illinois,Democratic,0,10,10
Patrick Murphy,Florida,Democratic,0,4,4
"Patrick Murphy, J.",Pennsylvania,Democratic,0,4,4
Scott Murphy,New York,Democratic,0,2,2
"Stephanie Murphy, N.",Florida,Democratic,0,4,4
Tim Murphy,Pennsylvania,Republican,0,14,14
Patty Murray,Washington,Democratic,28,0,28
"John Murtha, P.",Pennsylvania,Democratic,0,37,37
"Marilyn Musgrave, N.",Colorado,Republican,0,6,6
"Edmund Muskie, S.",Maine,Democratic,22,0,22
Raphael Musto,Pennsylvania,Democratic,0,2,2
"Gary Myers, A.",Pennsylvania,Republican,0,4,4
"John Myers, T.",Indiana,Republican,0,30,30
"Michael Myers, O.",Pennsylvania,Democratic,0,4,4
"Sue Myrick, Wilkins",North Carolina,Republican,0,18,18
Jerrold Nadler,New York,Democratic,0,30,30
"Dave Nagle, R",Iowa,Democratic,0,6,6
"John Napier, L.",South Carolina,Republican,0,2,2
"Grace Napolitano, F.",California,Democratic,0,22,22
"William Natcher, H.",Kentucky,Democratic,0,42,42
"Richard Neal, E.",Massachusetts,Democratic,0,32,32
"Stephen Neal, L.",North Carolina,Democratic,0,20,20
"Lucien Nedzi, N.",Michigan,Democratic,0,20,20
"McLeod, Negrete, Gloria",California,Democratic,0,2,2
Joe Neguse,Colorado,Democratic,0,2,2
"Troy Nehls, E.",Texas,Republican,0,0,0
"James Nelligan, L.",Pennsylvania,Republican,0,2,2
Ancher Nelsen,Minnesota,Republican,0,16,16
Ben Nelson,Nebraska,Democratic,12,0,12
Bill Nelson,Florida,Democratic,18,12,30
Gaylord Nelson,Wisconsin,Democratic,18,0,18
George Nethercutt,Washington,Republican,0,10,10
Randy Neugebauer,Texas,Republican,0,14,14
"Mark Neumann, W.",Wisconsin,Republican,0,4,4
Dan Newhouse,Washington,Republican,0,6,6
Marie Newman,Illinois,Democratic,0,0,0
"Robert Ney, W.",Ohio,Republican,0,12,12
Bill Nichols,Alabama,Democratic,0,22,22
Dick Nichols,Kansas,Republican,0,2,2
Don Nickles,Oklahoma,Republican,24,0,24
"Howard Nielson, C.",Utah,Republican,0,8,8
Robert Nix,Pennsylvania,Democratic,0,22,22
"Kristi Noem, L.",South Dakota,Republican,0,8,8
"Richard Nolan, M.",Minnesota,Democratic,0,12,12
Donald Norcross,New Jersey,Democratic,0,7,7
Ralph Norman,South Carolina,Republican,0,4,4
"Anne Northup, M.",Kentucky,Republican,0,10,10
"Eleanor Norton, Holmes",District of Columbia,Democratic,0,30,30
"Charles Norwood, W.",Georgia,Republican,0,12,12
Henry Nowak,New York,Democratic,0,18,18
"Richard Nugent, B.",Florida,Republican,0,6,6
Devin Nunes,California,Republican,0,18,18
Sam Nunn,Georgia,Democratic,26,0,26
Alan Nunnelee,Mississippi,Republican,0,4,4
Jim Nussle,Iowa,Republican,0,16,16
"Glenn Nye, C.",Virginia,Democratic,0,2,2
"George O'Brien, M.",Illinois,Republican,0,14,14
Tom O'Halleran,Arizona,Democratic,0,4,4
"James O'Hara, G.",Michigan,Democratic,0,18,18
Thomas O'Neill,Massachusetts,Democratic,0,34,34
Beto O'Rourke,Texas,Democratic,0,6,6
"Mary Oakar, Rose",Ohio,Democratic,0,16,16
Barack Obama,Illinois,Democratic,3,0,3
Jay Obernolte,California,Republican,0,0,0
"James Oberstar, L.",Minnesota,Democratic,0,36,36
"David Obey, R.",Wisconsin,Democratic,0,42,42
Alexandria Ocasio-Cortez,New York,Democratic,0,2,2
"James Olin, R.",Virginia,Democratic,0,10,10
Pete Olson,Texas,Republican,0,12,12
"John Olver, W.",Massachusetts,Democratic,0,22,22
Ilhan Omar,Minnesota,Democratic,0,2,2
"Solomon Ortiz, P.",Texas,Democratic,0,28,28
Bill Orton,Utah,Democratic,0,6,6
Tom Osborne,Nebraska,Republican,0,6,6
Doug Ose,California,Republican,0,6,6
Jon Ossoff,Georgia,Democratic,0,0,0
C. Otter,Idaho,Republican,0,6,6
"Richard Ottinger, L.",New York,Democratic,0,16,16
Burgess Owens,Utah,Republican,0,0,0
"Major Owens, R.",New York,Democratic,0,24,24
Wayne Owens,Utah,Democratic,0,8,8
"William Owens, L.",New York,Democratic,0,6,6
"Michael Oxley, G.",Ohio,Republican,0,26,26
Ron Packard,California,Republican,0,18,18
Bob Packwood,Oregon,Republican,28,0,28
Alex Padilla,California,Democratic,0,0,0
"Steven Palazzo, M.",Mississippi,Republican,0,10,10
"Frank, Pallone, Jr.",New Jersey,Democratic,0,34,34
"Gary Palmer, J.",Alabama,Republican,0,6,6
Jimmy Panetta,California,Democratic,0,4,4
Leon Panetta,California,Democratic,0,18,18
Chris Pappas,New Hampshire,Democratic,0,2,2
Michael Pappas,New Jersey,Republican,0,2,2
Mike Parker,Mississippi,Republican,0,10,10
Stanford Parris,Virginia,Republican,0,12,12
"Bill, Pascrell, Jr.",New Jersey,Democratic,0,24,24
"Charles, Pashayan, Jr.",California,Republican,0,12,12
"Otto Passman, E.",Louisiana,Democratic,0,30,30
Ed Pastor,Arizona,Democratic,0,24,24
"John Pastore, O.",Rhode Island,Democratic,28,0,28
"William Patman, N.",Texas,Democratic,0,4,4
Wright Patman,Texas,Democratic,0,48,48
"Edward Patten, J.",New Jersey,Democratic,0,18,18
Elizabeth Patterson,South Carolina,Democratic,0,6,6
"Jerry Patterson, M.",California,Democratic,0,10,10
"Edward Pattison, W.",New York,Democratic,0,4,4
Rand Paul,Kentucky,Republican,10,0,10
Ron Paul,Texas,Republican,0,18,18
Erik Paulsen,Minnesota,Republican,0,10,10
Bill Paxon,New York,Republican,0,10,10
"Donald Payne, M.",New Jersey,Democratic,0,23,23
Donald Payne,New Jersey,Democratic,0,9,9
Lewis Payne,Virginia,Democratic,0,10,10
Stevan Pearce,New Mexico,Republican,0,14,14
"James Pearson, B.",Kansas,Republican,18,0,18
"Donald Pease, J.",Ohio,Democratic,0,16,16
"Edward Pease, A.",Indiana,Republican,0,4,4
Claiborne Pell,Rhode Island,Democratic,36,0,36
Nancy Pelosi,California,Democratic,0,34,34
Greg Pence,Indiana,Republican,0,2,2
Mike Pence,Indiana,Republican,0,12,12
"Timothy Penny, J.",Minnesota,Democratic,0,12,12
Claude Pepper,Florida,Democratic,16,28,44
"Charles Percy, H.",Illinois,Republican,18,0,18
David Perdue,Georgia,Republican,6,0,6
"Carl Perkins, C.",Kentucky,Democratic,0,9,9
"Carl Perkins, Dewey",Kentucky,Democratic,0,36,36
Ed Perlmutter,Colorado,Democratic,0,14,14
"Thomas Perriello, S.P.",Virginia,Democratic,0,2,2
Scott Perry,Pennsylvania,Republican,0,8,8
"Gary Peters, C.",Michigan,Democratic,6,6,12
"Scott Peters, H.",California,Democratic,0,8,8
"Collin Peterson, C.",Minnesota,Democratic,0,30,30
"Douglas Peterson, (Pete)",Florida,Democratic,0,6,6
"John Peterson, E.",Pennsylvania,Republican,0,12,12
"Thomas Petri, E.",Wisconsin,Republican,0,36,36
"Jerry Pettis, L.",California,Republican,0,10,10
"Shirley Pettis, N.",California,Republican,0,4,4
"Peter Peyser, A.",New York,Democratic,0,10,10
August Pfluger,Texas,Republican,0,0,0
"David Phelps, D.",Illinois,Democratic,0,4,4
Dean Phillips,Minnesota,Democratic,0,2,2
Charles Pickering,Mississippi,Republican,0,12,12
"Owen Pickett, B.",Virginia,Democratic,0,14,14
"J. Pickle, J.",Texas,Democratic,0,32,32
"Pierluisi, Commissioner",Puerto Rico,Democratic,0,8,8
"Otis Pike, G.",New York,Democratic,0,18,18
Chellie Pingree,Maine,Democratic,0,12,12
Robert Pittenger,North Carolina,Republican,0,6,6
"Joseph Pitts, R.",Pennsylvania,Republican,0,20,20
"Stacey Plaskett, E.",Virgin Islands,Democratic,0,6,6
"Todd Platts, Russell",Pennsylvania,Republican,0,12,12
"W. Poage, R.",Texas,Democratic,0,42,42
Mark Pocan,Wisconsin,Democratic,0,8,8
"Bertram Podell, L.",New York,Democratic,0,8,8
Ted Poe,Texas,Republican,0,14,14
Bruce Poliquin,Maine,Republican,0,4,4
Jared Polis,Colorado,Democratic,0,10,10
"Richard Pombo, W.",California,Republican,0,14,14
Earl Pomeroy,North Dakota,Democratic,0,18,18
Mike Pompeo,Kansas,Republican,0,6,6
"John Porter, Edward",Illinois,Republican,0,22,22
"Jon Porter, C.",Nevada,Republican,0,6,6
Katie Porter,California,Democratic,0,2,2
Rob Portman,Ohio,Republican,10,14,24
Bill Posey,Florida,Republican,0,12,12
Glenn Poshard,Illinois,Democratic,0,10,10
"Walter Powell, E.",Ohio,Republican,0,4,4
Larry Pressler,South Dakota,Republican,18,4,22
Ayanna Pressley,Massachusetts,Democratic,0,2,2
Richardson Preyer,North Carolina,Democratic,0,12,12
"David Price, E.",North Carolina,Democratic,0,32,32
Melvin Price,Illinois,Democratic,0,44,44
"Robert Price, D.",Texas,Republican,0,8,8
Tom Price,Georgia,Republican,0,12,12
Joel Pritchard,Washington,Republican,0,12,12
William Proxmire,Wisconsin,Democratic,32,0,32
Deborah Pryce,Ohio,Republican,0,16,16
"David Pryor, H.",Arkansas,Democratic,18,8,26
"Mark Pryor, L.",Arkansas,Democratic,12,0,12
"Carl Pursell, D.",Michigan,Republican,0,16,16
"Adam Putnam, H.",Florida,Republican,0,10,10
Benjamin Quayle,Arizona,Republican,0,2,2
Dan Quayle,Indiana,Republican,10,4,14
"Albert Quie, H.",Minnesota,Republican,0,22,22
Mike Quigley,Illinois,Democratic,0,12,12
James Quillen,Tennessee,Republican,0,34,34
Jack Quinn,New York,Republican,0,12,12
George Radanovich,California,Republican,0,16,16
Trey Radel,Florida,Republican,0,1,1
Aumua Radewagen,American Samoa,Republican,0,6,6
Nick Rahall,West Virginia,Democratic,0,38,38
"Thomas Railsback, F.",Illinois,Republican,0,16,16
Jim Ramstad,Minnesota,Republican,0,18,18
"William Randall, J.",Missouri,Democratic,0,18,18
Jennings Randolph,West Virginia,Democratic,28,14,42
"Charles Rangel, B.",New York,Democratic,0,46,46
"John Rarick, R.",Louisiana,Democratic,0,8,8
Jamie Raskin,Maryland,Democratic,0,4,4
"William Ratchford, R.",Connecticut,Democratic,0,6,6
John Ratcliffe,Texas,Republican,0,5,5
"Arthur, Ravenel, Jr.",South Carolina,Republican,0,8,8
"Richard Ray, B.",Georgia,Democratic,0,10,10
Bill Redmond,New Mexico,Republican,0,2,2
Jack Reed,Rhode Island,Democratic,24,6,30
Tom Reed,New York,Republican,0,11,11
"Thomas Rees, M.",California,Democratic,0,12,12
Ralph Regula,Ohio,Republican,0,36,36
Denny Rehberg,Montana,Republican,0,12,12
"David Reichert, G.",Washington,Republican,0,14,14
Harry Reid,Nevada,Democratic,30,4,34
"Ogden Reid, R.",New York,Democratic,0,12,12
"James Renacci, B.",Ohio,Republican,0,8,8
Rick Renzi,Arizona,Republican,0,6,6
Guy Reschenthaler,Pennsylvania,Republican,0,2,2
"Henry Reuss, S.",Wisconsin,Democratic,0,28,28
Silvestre Reyes,Texas,Democratic,0,16,16
Mel Reynolds,Illinois,Democratic,0,4,4
"Thomas Reynolds, M.",New York,Republican,0,10,10
"John Rhodes, J.",Arizona,Republican,0,30,30
John Rhodes,Arizona,Republican,0,6,6
"Reid Ribble, J.",Wisconsin,Republican,0,6,6
"Abraham Ribicoff, A.",Connecticut,Democratic,18,4,22
"Kathleen Rice, M.",New York,Democratic,0,6,6
Tom Rice,South Carolina,Republican,0,8,8
Bill Richardson,New Mexico,Democratic,0,16,16
Laura Richardson,California,Democratic,0,6,6
"Cedric Richmond, L.",Louisiana,Democratic,0,10,10
"Frederick Richmond, W.",New York,Democratic,0,8,8
"Thomas Ridge, J.",Pennsylvania,Republican,0,12,12
Donald Riegle,Michigan,Democratic,18,10,28
"E. Rigell, Scott",Virginia,Republican,0,6,6
Denver Riggleman,Virginia,Republican,0,2,2
Frank Riggs,California,Republican,0,6,6
Bob Riley,Alabama,Republican,0,6,6
"Matthew Rinaldo, J.",New Jersey,Republican,0,20,20
"James Risch, E.",Idaho,Republican,12,0,12
"Theodore Risenhoover, M.",Oklahoma,Democratic,0,4,4
Don Ritter,Pennsylvania,Republican,0,14,14
David Rivera,Florida,Republican,0,2,2
"Lynn Rivers, N.",Michigan,Democratic,0,8,8
"Charles Robb, S.",Virginia,Democratic,12,0,12
Clint Roberts,South Dakota,Republican,0,2,2
Pat Roberts,Kansas,Republican,24,16,40
Ray Roberts,Texas,Democratic,0,20,20
"J. Robinson, Kenneth",Virginia,Republican,0,14,14
"Tommy Robinson, F.",Arkansas,Republican,0,6,6
"Howard Robison, W.",New York,Republican,0,18,18
Martha Roby,Alabama,Republican,0,10,10
John Rockefeller,West Virginia,Democratic,30,0,30
Peter Rodino,New Jersey,Democratic,0,40,40
"Ciro Rodriguez, D.",Texas,Democratic,0,12,12
"David Roe, P.",Tennessee,Republican,0,12,12
"Robert Roe, A.",New Jersey,Democratic,0,24,24
Buddy Roemer,Louisiana,Democratic,0,8,8
Tim Roemer,Indiana,Democratic,0,12,12
"James Rogan, E.",California,Republican,0,4,4
Harold Rogers,Kentucky,Republican,0,40,40
"Mike Rogers, D.",Alabama,Republican,0,18,18
"Mike Rogers, J.",Michigan,Republican,0,14,14
"Paul Rogers, G.",Florida,Democratic,0,24,24
Dana Rohrabacher,California,Republican,0,30,30
Todd Rokita,Indiana,Republican,0,8,8
"Romero-Barcelo, Commissioner",Puerto Rico,Democratic,0,8,8
Mitt Romney,Utah,Republican,2,0,2
Teno Roncalio,Wyoming,Democratic,0,10,10
"Angelo Roncallo, D.",New York,Republican,0,2,2
Francis Rooney,Florida,Republican,0,4,4
"Fred Rooney, B.",Pennsylvania,Democratic,0,16,16
"John Rooney, J.",New York,Democratic,0,32,32
"Thomas Rooney, J.",Florida,Republican,0,10,10
Ileana Ros-Lehtinen,Florida,Republican,0,30,30
Charlie Rose,North Carolina,Democratic,0,24,24
"John Rose, W.",Tennessee,Republican,0,2,2
Max Rose,New York,Democratic,0,2,2
Jacky Rosen,Nevada,Democratic,2,2,4
"Sr., Rosendale",Montana,Republican,0,0,0
"Benjamin Rosenthal, S.",New York,Democratic,0,22,22
"Peter Roskam, J.",Illinois,Republican,0,12,12
"Deborah Ross, K.",North Carolina,Democratic,0,0,0
"Dennis Ross, A.",Florida,Republican,0,8,8
Mike Ross,Arkansas,Democratic,0,12,12
Dan Rostenkowski,Illinois,Democratic,0,36,36
"Jr., Roth",Delaware,Republican,32,2,34
Toby Roth,Wisconsin,Republican,0,18,18
"Keith Rothfus, J.",Pennsylvania,Republican,0,6,6
"Steven Rothman, R.",New Jersey,Democratic,0,16,16
Harley Rouda,California,Democratic,0,2,2
Marge Roukema,New Jersey,Republican,0,22,22
Mike Rounds,South Dakota,Republican,6,0,6
"J. Roush, Edward",Indiana,Democratic,0,16,16
"John Rousselot, H.",California,Republican,0,16,16
David Rouzer,North Carolina,Republican,0,6,6
"J. Rowland, Roy",Georgia,Democratic,0,12,12
"John Rowland, G.",Connecticut,Republican,0,6,6
Chip Roy,Texas,Republican,0,2,2
"William Roy, R.",Kansas,Democratic,0,4,4
"Edward Roybal, R.",California,Democratic,0,30,30
Lucille Roybal-Allard,California,Democratic,0,28,28
"Edward Royce, R.",California,Republican,0,26,26
William Royer,California,Republican,0,2,2
Marco Rubio,Florida,Republican,10,0,10
"Eldon Rudd, D.",Arizona,Republican,0,10,10
Warren Rudman,New Hampshire,Republican,12,0,12
Raul Ruiz,California,Democratic,0,8,8
"Harold Runnels, L.",New Mexico,Democratic,0,10,10
Jon Runyan,New Jersey,Republican,0,4,4
"Philip Ruppe, E.",Michigan,Republican,0,12,12
C. Ruppersberger,Maryland,Democratic,0,18,18
"Bobby Rush, L.",Illinois,Democratic,0,28,28
Steve Russell,Oklahoma,Republican,0,4,4
"Martin Russo, A.",Illinois,Democratic,0,18,18
"Earl Ruth, B.",North Carolina,Republican,0,6,6
"John Rutherford, H.",Florida,Republican,0,4,4
"Leo Ryan, J.",California,Democratic,0,6,6
"Paul Ryan, D.",Wisconsin,Republican,0,20,20
Tim Ryan,Ohio,Democratic,0,18,18
Jim Ryun,Kansas,Republican,0,10,10
Gregorio Sablan,Northern Mariana Islands,Democratic,0,12,12
"Martin Sabo, Olav",Minnesota,Democratic,0,28,28
Patricia Saiki,Hawaii,Republican,0,4,4
"John Salazar, T.",Colorado,Democratic,0,6,6
Ken Salazar,Colorado,Democratic,4,0,4
"Maria Salazar, Elvira",Florida,Republican,0,0,0
Bill Sali,Idaho,Republican,0,2,2
Matt Salmon,Arizona,Republican,0,10,10
"Nicolas, San",Guam,Democratic,0,2,2
"Linda Sanchez, T.",California,Democratic,0,18,18
Loretta Sanchez,California,Democratic,0,20,20
Bernard Sanders,Vermont,Independent,14,16,30
Max Sandlin,Texas,Democratic,0,8,8
Charles Sandman,New Jersey,Republican,0,8,8
Mark Sanford,South Carolina,Republican,0,12,12
Terry Sanford,North Carolina,Democratic,8,0,8
"George Sangmeister, E.",Illinois,Democratic,0,6,6
"James Santini, D.",Nevada,Democratic,0,8,8
Rick Santorum,Pennsylvania,Republican,12,4,16
"Ronald Sarasin, A.",Connecticut,Republican,0,6,6
"John Sarbanes, P.",Maryland,Democratic,0,14,14
"Paul Sarbanes, S.",Maryland,Democratic,30,6,36
Bill Sarpalius,Texas,Democratic,0,6,6
Ben Sasse,Nebraska,Republican,6,0,6
Jim Sasser,Tennessee,Democratic,18,0,18
David Satterfield,Virginia,Democratic,0,16,16
Gus Savage,Illinois,Democratic,0,12,12
"Harold Sawyer, S.",Michigan,Republican,0,8,8
Tom Sawyer,Ohio,Democratic,0,16,16
"William Saxbe, B.",Ohio,Republican,6,0,6
Jim Saxton,New Jersey,Republican,0,24,24
"John Saylor, P.",Pennsylvania,Republican,0,26,26
Steve Scalise,Louisiana,Republican,0,13,13
"Mary Scanlon, Gay",Pennsylvania,Democratic,0,3,3
Joe Scarborough,Florida,Republican,0,6,6
Dan Schaefer,Colorado,Republican,0,16,16
Bob Schaffer,Colorado,Republican,0,6,6
"Janice Schakowsky, D.",Illinois,Democratic,0,22,22
Brian Schatz,Hawaii,Democratic,9,0,9
"Mark Schauer, H.",Michigan,Democratic,0,2,2
Lynn Schenk,California,Democratic,0,2,2
"William Scherle, J.",Iowa,Republican,0,8,8
"James Scheuer, H.",New York,Democratic,0,26,26
"Adam Schiff, B.",California,Democratic,0,20,20
Steven Schiff,New Mexico,Republican,0,10,10
"Robert Schilling, T.",Illinois,Republican,0,2,2
Jean Schmidt,Ohio,Republican,0,8,8
"Harrison Schmitt, H.",New Mexico,Republican,6,0,6
"Herman Schneebeli, T.",Pennsylvania,Republican,0,18,18
"Bradley Schneider, Scott",Illinois,Democratic,0,6,6
Claudine Schneider,Rhode Island,Republican,0,10,10
Aaron Schock,Illinois,Republican,0,6,6
Kurt Schrader,Oregon,Democratic,0,12,12
Kim Schrier,Washington,Democratic,0,2,2
"Edward Schrock, L.",Virginia,Republican,0,4,4
Patricia Schroeder,Colorado,Democratic,0,24,24
Bill Schuette,Michigan,Republican,0,6,6
"Richard Schulze, T.",Pennsylvania,Republican,0,18,18
"Charles Schumer, E.",New York,Democratic,22,18,40
"Allyson Schwartz, Y.",Pennsylvania,Democratic,0,10,10
John Schwarz,Michigan,Republican,0,2,2
"Richard Schweiker, S.",Pennsylvania,Republican,12,8,20
David Schweikert,Arizona,Republican,0,10,10
Austin Scott,Georgia,Republican,0,10,10
David Scott,Georgia,Democratic,0,18,18
Hugh Scott,Pennsylvania,Republican,18,16,34
Rick Scott,Florida,Republican,2,0,2
Robert Scott,Virginia,Democratic,0,28,28
Tim Scott,South Carolina,Republican,8,2,10
"William Scott, Lloyd",Virginia,Republican,6,6,12
"Andrea Seastrand, H.",California,Republican,0,2,2
"Keith Sebelius, G.",Kansas,Republican,0,12,12
"John Seiberling, F.",Ohio,Democratic,0,16,16
"Gibbs, Sekula, Shelley",Texas,Republican,0,2,2
F. Sensenbrenner,Wisconsin,Republican,0,42,42
"Jose Serrano, E.",New York,Democratic,0,32,32
Jeff Sessions,Alabama,Republican,20,0,20
Pete Sessions,Texas,Republican,0,22,22
Joe Sestak,Pennsylvania,Democratic,0,4,4
"Terri Sewell, A.",Alabama,Democratic,0,10,10
John Seymour,California,Republican,2,0,2
"John Shadegg, B.",Arizona,Republican,0,16,16
Jeanne Shaheen,New Hampshire,Democratic,12,0,12
"Donna Shalala, E.",Florida,Democratic,0,2,2
Bob Shamansky,Ohio,Democratic,0,2,2
"James Shannon, M.",Massachusetts,Democratic,0,6,6
"Philip Sharp, R.",Indiana,Democratic,0,20,20
E. Shaw,Florida,Republican,0,26,26
Christopher Shays,Connecticut,Republican,0,22,22
Carol Shea-Porter,New Hampshire,Democratic,0,6,6
"Richard Shelby, C.",Alabama,Republican,34,8,42
Karen Shepherd,Utah,Democratic,0,2,2
Brad Sherman,California,Democratic,0,24,24
Mikie Sherrill,New Jersey,Democratic,0,2,2
Don Sherwood,Pennsylvania,Republican,0,8,8
John Shimkus,Illinois,Republican,0,24,24
"George Shipley, E.",Illinois,Democratic,0,20,20
Dick Shoup,Montana,Republican,0,4,4
Ronnie Shows,Mississippi,Democratic,0,4,4
"Garner Shriver, E.",Kansas,Republican,0,16,16
Heath Shuler,North Carolina,Democratic,0,6,6
"Norman Shumway, D.",California,Republican,0,12,12
Bill Shuster,Pennsylvania,Republican,0,18,18
Bud Shuster,Pennsylvania,Republican,0,28,28
Robert Sikes,Florida,Democratic,0,38,38
"Gerry Sikorski, E.",Minnesota,Democratic,0,10,10
"Mark Siljander, D.",Michigan,Republican,0,6,6
Rob Simmons,Connecticut,Republican,0,6,6
Paul Simon,Illinois,Democratic,12,10,22
"Alan Simpson, K.",Wyoming,Republican,18,0,18
"Michael Simpson, K.",Idaho,Republican,0,22,22
Kyrsten Sinema,Arizona,Democratic,2,6,8
Albio Sires,New Jersey,Democratic,0,16,16
Norman Sisisky,Virginia,Democratic,0,18,18
"B. Sisk, F.",California,Democratic,0,24,24
"David Skaggs, E.",Colorado,Democratic,0,12,12
Joe Skeen,New Mexico,Republican,0,22,22
Ike Skelton,Missouri,Democratic,0,34,34
Joe Skubitz,Kansas,Republican,0,16,16
John Slack,West Virginia,Democratic,0,22,22
Jim Slattery,Kansas,Democratic,0,12,12
D. Slaughter,Virginia,Republican,0,8,8
"Louise Slaughter, McIntosh",New York,Democratic,0,31,31
Elissa Slotkin,Michigan,Democratic,0,2,2
Adam Smith,Washington,Democratic,0,24,24
Adrian Smith,Nebraska,Republican,0,14,14
Albert Smith,Alabama,Republican,0,2,2
Bob Smith,New Hampshire,Republican,12,6,18
"Christopher Smith, H.",New Jersey,Republican,0,40,40
Denny Smith,Oregon,Republican,0,10,10
"Gordon Smith, H.",Oregon,Republican,12,0,12
Henry Smith,New York,Republican,0,10,10
Jason Smith,Missouri,Republican,0,8,8
"Joseph Smith, F.",Pennsylvania,Democratic,0,2,2
Lamar Smith,Texas,Republican,0,32,32
Larkin Smith,Mississippi,Republican,0,2,2
Lawrence Smith,Florida,Democratic,0,10,10
Linda Smith,Washington,Republican,0,4,4
"Neal Smith, Edward",Iowa,Democratic,0,36,36
Nick Smith,Michigan,Republican,0,12,12
Peter Smith,Vermont,Republican,0,2,2
Robert Smith,Oregon,Republican,0,14,14
Tina Smith,Minnesota,Democratic,3,0,3
Virginia Smith,Nebraska,Republican,0,16,16
Lloyd Smucker,Pennsylvania,Republican,0,4,4
Vince Snowbarger,Kansas,Republican,0,2,2
"Olympia Snowe, J.",Maine,Republican,18,16,34
M. Snyder,Kentucky,Republican,0,22,22
Vic Snyder,Arkansas,Democratic,0,14,14
"Michael Sodrel, E.",Indiana,Republican,0,2,2
"Stephen Solarz, J.",New York,Democratic,0,18,18
"Hilda Solis, L.",California,Democratic,0,8,8
Gerald Solomon,New York,Republican,0,20,20
Darren Soto,Florida,Democratic,0,4,4
"Mark Souder, E.",Indiana,Republican,0,15,15
"Steve Southerland, II",Florida,Republican,0,4,4
"Zachary Space, T.",Ohio,Democratic,0,4,4
"Abigail Spanberger, Davis",Virginia,Democratic,0,2,2
Ross Spano,Florida,Republican,0,2,2
"John Sparkman, J.",Alabama,Democratic,34,8,42
Victoria Spartz,Indiana,Republican,0,0,0
Arlen Specter,Pennsylvania,Democratic,30,0,30
Jackie Speier,California,Democratic,0,13,13
"Gladys Spellman, Noon",Maryland,Democratic,0,8,8
Floyd Spence,South Carolina,Republican,0,30,30
John Spratt,South Carolina,Democratic,0,28,28
"Germain, St",Rhode Island,Democratic,0,28,28
Debbie Stabenow,Michigan,Democratic,20,4,24
"Edward Stack, J.",Florida,Democratic,0,2,2
"Robert Stafford, T.",Vermont,Republican,18,10,28
"Harley Staggers, O.",West Virginia,Democratic,0,32,32
Harley Staggers,West Virginia,Democratic,0,10,10
"Richard Stallings, H.",Idaho,Democratic,0,8,8
Arlan Stangeland,Minnesota,Republican,0,14,14
Greg Stanton,Arizona,Democratic,0,2,2
"J. Stanton, William",Ohio,Republican,0,18,18
"James Stanton, V.",Ohio,Independent,0,6,6
"Fortney Stark, Pete",California,Democratic,0,40,40
"David Staton, Michael",West Virginia,Republican,0,2,2
Pete Stauber,Minnesota,Republican,0,2,2
Cliff Stearns,Florida,Republican,0,24,24
Tom Steed,Oklahoma,Democratic,0,32,32
Michelle Steel,California,Republican,0,0,0
"Robert Steele, H.",Connecticut,Republican,0,6,6
Alan Steelman,Texas,Republican,0,4,4
Newton Steers,Maryland,Republican,0,2,2
"Elise Stefanik, M.",New York,Republican,0,6,6
Sam Steiger,Arizona,Republican,0,10,10
"William Steiger, A.",Wisconsin,Republican,0,14,14
Bryan Steil,Wisconsin,Republican,0,2,2
"Charles Stenholm, W.",Texas,Democratic,0,26,26
"John Stennis, C.",Mississippi,Democratic,42,0,42
Robert Stephens,Georgia,Democratic,0,16,16
"W. Steube, Gregory",Florida,Republican,0,2,2
"Haley Stevens, M.",Michigan,Democratic,0,2,2
Ted Stevens,Alaska,Republican,42,0,42
Adlai Stevenson,Illinois,Democratic,12,0,12
"Bennett Stewart, McVey",Illinois,Democratic,0,2,2
Chris Stewart,Utah,Republican,0,8,8
Donald Stewart,Alabama,Democratic,4,0,4
Steve Stivers,Ohio,Republican,0,10,10
"David Stockman, A.",Michigan,Republican,0,6,6
Steve Stockman,Texas,Republican,0,4,4
Louis Stokes,Ohio,Democratic,0,30,30
"Richard Stone, (Dick)",Florida,Democratic,6,0,6
"Michael Strang, L.",Colorado,Republican,0,2,2
Luther Strange,Alabama,Republican,1,0,1
"Samuel Stratton, S.",New York,Democratic,0,30,30
Marilyn Strickland,Washington,Democratic,0,0,0
Ted Strickland,Ohio,Democratic,0,12,12
"Frank Stubblefield, A.",Kentucky,Democratic,0,16,16
W. Stuckey,Georgia,Democratic,0,10,10
"Gerry Studds, E.",Massachusetts,Democratic,0,24,24
Bob Stump,Arizona,Republican,0,26,26
Bart Stupak,Michigan,Democratic,0,18,18
"Marlin Stutzman, A.",Indiana,Republican,0,7,7
Dan Sullivan,Alaska,Republican,6,0,6
John Sullivan,Oklahoma,Republican,0,11,11
Leonor Sullivan,Missouri,Democratic,0,24,24
Don Sundquist,Tennessee,Republican,0,12,12
Foto Sunia,American Samoa,Democratic,0,8,8
"John Sununu, E.",New Hampshire,Republican,6,6,12
"Thomas Suozzi, R.",New York,Democratic,0,4,4
Betty Sutton,Ohio,Democratic,0,6,6
Eric Swalwell,California,Democratic,0,8,8
"David Sweeney, McCann",Texas,Republican,0,4,4
"John Sweeney, E.",New York,Republican,0,8,8
Dick Swett,New Hampshire,Democratic,0,4,4
Al Swift,Washington,Democratic,0,16,16
"Patrick Swindall, L.",Georgia,Republican,0,4,4
"James Symington, W.",Missouri,Democratic,0,8,8
Stuart Symington,Missouri,Democratic,24,0,24
"Steven Symms, D.",Idaho,Republican,12,8,20
Mike Synar,Oklahoma,Democratic,0,16,16
"Robert, Taft, Jr.",Ohio,Republican,6,6,12
Mark Takai,Hawaii,Democratic,0,1,1
Mark Takano,California,Democratic,0,8,8
"Burt Talcott, L.",California,Republican,0,14,14
Jim Talent,Missouri,Republican,5,8,13
Robert Tallon,South Carolina,Democratic,0,10,10
"Herman Talmadge, E.",Georgia,Democratic,24,0,24
"Thomas Tancredo, G.",Colorado,Republican,0,10,10
"John Tanner, S.",Tennessee,Democratic,0,22,22
Randy Tate,Washington,Republican,0,2,2
"Thomas Tauke, Joseph",Iowa,Republican,0,12,12
"Ellen Tauscher, O.",California,Democratic,0,12,12
W. Tauzin,Louisiana,Republican,0,26,26
"Charles Taylor, H.",North Carolina,Republican,0,16,16
G. Taylor,Missouri,Republican,0,16,16
Gene Taylor,Mississippi,Democratic,0,22,22
"Roy Taylor, A.",North Carolina,Democratic,0,18,18
Scott Taylor,Virginia,Republican,0,2,2
Van Taylor,Texas,Republican,0,2,2
"Charles Teague, M.",California,Republican,0,20,20
Harry Teague,New Mexico,Democratic,0,2,2
"Olin Teague, E.",Texas,Democratic,0,34,34
Frank Tejeda,Texas,Democratic,0,6,6
Claudia Tenney,New York,Republican,0,2,2
Lee Terry,Nebraska,Republican,0,16,16
Jon Tester,Montana,Democratic,14,0,14
Craig Thomas,Wyoming,Republican,12,6,18
Lindsay Thomas,Georgia,Democratic,0,10,10
"William Thomas, M.",California,Republican,0,28,28
"Bennie Thompson, G.",Mississippi,Democratic,0,28,28
"Frank, Thompson, Jr.",New Jersey,Democratic,0,26,26
Fred Thompson,Tennessee,Republican,9,0,9
Glenn Thompson,Pennsylvania,Republican,0,12,12
Mike Thompson,California,Democratic,0,22,22
"Vernon Thomson, W.",Wisconsin,Republican,0,14,14
Charles Thone,Nebraska,Republican,0,8,8
Mac Thornberry,Texas,Republican,0,26,26
Ray Thornton,Arkansas,Democratic,0,12,12
John Thune,South Dakota,Republican,16,6,22
"Karen Thurman, L.",Florida,Democratic,0,10,10
Strom Thurmond,South Carolina,Republican,50,0,50
Todd Tiahrt,Kansas,Republican,0,16,16
"Patrick Tiberi, J.",Ohio,Republican,0,17,17
"Robert Tiernan, O.",Rhode Island,Democratic,0,8,8
"John Tierney, F.",Massachusetts,Democratic,0,18,18
"Thomas Tiffany, P.",Wisconsin,Republican,0,1,1
Thom Tillis,North Carolina,Republican,6,0,6
William Timmons,South Carolina,Republican,0,2,2
"Scott Tipton, R.",Colorado,Republican,0,10,10
Dina Titus,Nevada,Democratic,0,10,10
Rashida Tlaib,Michigan,Democratic,0,2,2
Paul Tonko,New York,Democratic,0,12,12
"Richard Tonry, A.",Louisiana,Democratic,0,2,2
Pat Toomey,Pennsylvania,Republican,10,6,16
"Peter Torkildsen, G.",Massachusetts,Republican,0,4,4
"Small, Torres, Xochitl",New Mexico,Democratic,0,2,2
"Estaban Torres, Edward",California,Democratic,0,16,16
"Norma Torres, J.",California,Democratic,0,6,6
Ritchie Torres,New York,Democratic,0,0,0
"Robert Torricelli, G.",New Jersey,Democratic,6,14,20
David Towell,Nevada,Republican,0,2,2
"John Tower, G.",Texas,Republican,24,0,24
Edolphus Towns,New York,Democratic,0,30,30
James Traficant,Ohio,Democratic,0,17,17
Lori Trahan,Massachusetts,Democratic,0,2,2
Bob Traxler,Michigan,Democratic,0,20,20
"David Treen, C.",Louisiana,Republican,0,8,8
Paul Trible,Virginia,Republican,6,6,12
"David Trone, J.",Maryland,Democratic,0,2,2
"David Trott, A.",Michigan,Republican,0,4,4
Niki Tsongas,Massachusetts,Democratic,0,12,12
"Paul Tsongas, E.",Massachusetts,Democratic,6,4,10
Tommy Tuberville,Alabama,Republican,0,0,0
James Tucker,Arkansas,Democratic,0,2,2
Walter Tucker,California,Democratic,0,4,4
"John Tunney, V.",California,Democratic,4,8,12
Jim Turner,Texas,Democratic,0,8,8
"Michael Turner, R.",Ohio,Republican,0,18,18
"Robert Turner, L.",New York,Republican,0,2,2
Mark Udall,Colorado,Democratic,6,10,16
"Morris Udall, K.",Arizona,Democratic,0,32,32
Tom Udall,New Mexico,Democratic,12,10,22
Al Ullman,Oregon,Democratic,0,24,24
Lauren Underwood,Illinois,Democratic,0,2,2
"Robert Underwood, A.",Guam,Democratic,0,10,10
Jolene Unsoeld,Washington,Democratic,0,6,6
Fred Upton,Michigan,Republican,0,34,34
"David Valadao, G.",California,Republican,0,6,6
Tim Valentine,North Carolina,Democratic,0,12,12
"Deerlin, Van, Lionel",California,Democratic,0,18,18
"Drew, Van, Jefferson",New Jersey,Republican,0,2,2
"Duyne, Van, Beth",Texas,Republican,0,0,0
"Hollen, Van, Chris",Maryland,Democratic,4,14,18
"Jagt, Vander, Guy",Michigan,Republican,0,28,28
"Veen, Vander",Michigan,Democratic,0,4,4
"Tommy Vandergriff, J.",Texas,Democratic,0,2,2
"Charles Vanik, A.",Ohio,Democratic,0,26,26
Juan Vargas,California,Democratic,0,8,8
"Marc Veasey, A.",Texas,Democratic,0,8,8
Filemon Vela,Texas,Democratic,0,8,8
"Nydia Velazquez, M.",New York,Democratic,0,28,28
"Bruce Vento, F.",Minnesota,Democratic,0,24,24
"Victor Veysey, V.",California,Republican,0,4,4
"Joseph Vigorito, P.",Pennsylvania,Democratic,0,12,12
"Peter Visclosky, J.",Indiana,Democratic,0,36,36
David Vitter,Louisiana,Republican,12,6,18
"George Voinovich, V.",Ohio,Republican,12,0,12
"Harold Volkmer, L.",Missouri,Democratic,0,20,20
"Barbara Vucanovich, F.",Nevada,Republican,0,14,14
Joe Waggonner,Louisiana,Democratic,0,18,18
Ann Wagner,Missouri,Republican,0,8,8
Tim Walberg,Michigan,Republican,0,12,12
Greg Walden,Oregon,Republican,0,22,22
"Enid Waldholtz, Greene",Utah,Republican,0,2,2
"Jerome Waldie, R.",California,Democratic,0,10,10
Alton Waldon,New York,Democratic,0,2,2
Doug Walgren,Pennsylvania,Democratic,0,14,14
Mark Walker,North Carolina,Republican,0,6,6
"Robert Walker, S.",Pennsylvania,Republican,0,20,20
Malcolm Wallop,Wyoming,Republican,18,0,18
Jackie Walorski,Indiana,Republican,0,8,8
"James Walsh, T.",New York,Republican,0,20,20
Joe Walsh,Illinois,Republican,0,2,2
"John Walsh, E.",Montana,Democratic,1,0,1
"William Walsh, F.",New York,Republican,0,6,6
Mimi Walters,California,Republican,0,4,4
Michael Waltz,Florida,Republican,0,2,2
"Timothy Walz, J.",Minnesota,Democratic,0,12,12
Zach Wamp,Tennessee,Republican,0,16,16
"William Wampler, C.",Virginia,Republican,0,18,18
Mike Ward,Kentucky,Democratic,0,2,2
"John Ware, H.",Pennsylvania,Republican,0,6,6
John Warner,Virginia,Republican,30,0,30
"Mark Warner, R.",Virginia,Democratic,12,0,12
"Raphael Warnock, G.",Georgia,Democratic,0,0,0
Elizabeth Warren,Massachusetts,Democratic,8,0,8
"Craig Washington, A.",Texas,Democratic,0,6,6
Harold Washington,Illinois,Democratic,0,4,4
"Schultz, Wasserman, Debbie",Florida,Democratic,0,16,16
Maxine Waters,California,Democratic,0,30,30
Steve Watkins,Kansas,Republican,0,2,2
Wes Watkins,Oklahoma,Republican,0,20,20
"Coleman, Watson, Bonnie",New Jersey,Democratic,0,6,6
"Diane Watson, E.",California,Democratic,0,10,10
"Melvin Watt, L.",North Carolina,Democratic,0,21,21
J. Watts,Oklahoma,Republican,0,8,8
"Henry Waxman, A.",California,Democratic,0,40,40
"James Weaver, H.",Oregon,Democratic,0,12,12
Jim Webb,Virginia,Democratic,6,0,6
Ed Weber,Ohio,Republican,0,2,2
Randy Weber,Texas,Republican,0,8,8
Vin Weber,Minnesota,Republican,0,12,12
Daniel Webster,Florida,Republican,0,10,10
Lowell Weicker,Connecticut,Republican,16,2,18
"Anthony Weiner, D.",New York,Democratic,0,12,12
Ted Weiss,New York,Democratic,0,16,16
Peter Welch,Vermont,Democratic,0,14,14
Curt Weldon,Pennsylvania,Republican,0,20,20
Dave Weldon,Florida,Republican,0,14,14
Jerry Weller,Illinois,Republican,0,14,14
"Paul Wellstone, D.",Minnesota,Democratic,11,0,11
"Brad Wenstrup, R.",Ohio,Republican,0,8,8
"Allen West, B.",Florida,Republican,0,2,2
Bruce Westerman,Arkansas,Republican,0,6,6
"Lynn Westmoreland, A.",Georgia,Republican,0,12,12
Robert Wexler,Florida,Democratic,0,13,13
Jennifer Wexton,Virginia,Democratic,0,2,2
"Robert Weygand, A.",Rhode Island,Democratic,0,4,4
Charles Whalen,Ohio,Republican,0,12,12
Alan Wheat,Missouri,Democratic,0,12,12
"Richard White, C.",Texas,Democratic,0,18,18
Rick White,Washington,Republican,0,4,4
Sheldon Whitehouse,Rhode Island,Democratic,14,0,14
"G. Whitehurst, William",Virginia,Republican,0,18,18
Ed Whitfield,Kentucky,Republican,0,21,21
Charles Whitley,North Carolina,Democratic,0,10,10
Bob Whittaker,Kansas,Republican,0,12,12
"Jamie Whitten, L.",Mississippi,Democratic,0,28,28
"Roger Wicker, F.",Mississippi,Republican,14,12,26
"William Widnall, B.",New Jersey,Republican,0,26,26
"Charles Wiggins, E.",California,Republican,0,12,12
Susan Wild,Pennsylvania,Democratic,0,3,3
Harrison Williams,New Jersey,Democratic,23,4,27
"Lawrence Williams, G.",Pennsylvania,Republican,0,8,8
Lyle Williams,Ohio,Republican,0,6,6
Nikema Williams,Georgia,Democratic,0,0,0
Pat Williams,Montana,Democratic,0,18,18
Roger Williams,Texas,Republican,0,8,8
Charles Wilson,Texas,Democratic,0,24,24
"Charles Wilson, A.",Ohio,Democratic,0,4,4
"Charles Wilson, H.",California,Democratic,0,18,18
"Frederica Wilson, S.",Florida,Democratic,0,10,10
Heather Wilson,New Mexico,Republican,0,12,12
Joe Wilson,South Carolina,Republican,0,20,20
Pete Wilson,California,Republican,10,0,10
"Robert Wilson, C.",California,Republican,0,28,28
"Larry, Winn, Jr.",Kansas,Republican,0,18,18
Timothy Wirth,Colorado,Democratic,6,12,18
Robert Wise,West Virginia,Democratic,0,18,18
"Robert Wittman, J.",Virginia,Republican,0,14,14
Harris Wofford,Pennsylvania,Democratic,4,0,4
"Frank Wolf, R.",Virginia,Republican,0,34,34
"Lester Wolff, L.",New York,Democratic,0,16,16
"Howard Wolpe, E.",Michigan,Democratic,0,14,14
Steve Womack,Arkansas,Republican,0,10,10
"Pat, Won",Guam,Democratic,0,12,12
Rob Woodall,Georgia,Republican,0,10,10
"Lynn Woolsey, C.",California,Democratic,0,20,20
"George Wortley, C.",New York,Republican,0,8,8
James Wright,Texas,Democratic,0,36,36
Ron Wright,Texas,Republican,0,2,2
David Wu,Oregon,Democratic,0,12,12
"Joe, Wyatt, Jr.",Texas,Democratic,0,2,2
Wendell Wyatt,Oregon,Republican,0,12,12
Ron Wyden,Oregon,Democratic,25,15,40
"John Wydler, W.",New York,Republican,0,18,18
"Chalmers Wylie, P.",Ohio,Republican,0,26,26
"Louis Wyman, C.",New Hampshire,Republican,1,9,10
"Albert Wynn, Russell",Maryland,Democratic,0,15,15
"John Yarmuth, A.",Kentucky,Democratic,0,14,14
"Sidney Yates, R.",Illinois,Democratic,0,48,48
Gus Yatron,Pennsylvania,Democratic,0,24,24
Kevin Yoder,Kansas,Republican,0,8,8
"Ted Yoho, S.",Florida,Republican,0,8,8
Andrew Young,Georgia,Democratic,0,6,6
C. Young,Florida,Republican,0,42,42
David Young,Iowa,Republican,0,4,4
Don Young,Alaska,Republican,0,48,48
Edward Young,South Carolina,Republican,0,2,2
John Young,Texas,Democratic,0,22,22
"Milton Young, R.",North Dakota,Republican,36,0,36
"Robert Young, A.",Missouri,Democratic,0,10,10
"Samuel Young, H.",Illinois,Republican,0,2,2
Todd Young,Indiana,Republican,4,6,10
"Clement Zablocki, J.",Wisconsin,Democratic,0,36,36
"Leo Zeferetti, C.",New York,Democratic,0,8,8
"Lee Zeldin, M.",New York,Republican,0,6,6
William Zeliff,New Hampshire,Republican,0,6,6
Dick Zimmer,New Jersey,Republican,0,6,6
"Ryan Zinke, K.",Montana,Republican,0,2,2
"Roger Zion, H.",Indiana,Republican,0,8,8
Edward Zorinsky,Nebraska,Democratic,12,0,12
Edwin Zschau,California,Republican,0,4,4
"John Zwach, M.",Minnesota,Republican,0,8,8
